Team,Map,Wins,Loses,Total Games,Win Rate
00NATION,Ancient,14,10,24,0.5833333333333334
00NATION,Anubis,1,0,1,1.0
00NATION,Dust2,11,5,16,0.6875
00NATION,Inferno,18,13,31,0.5806451612903226
00NATION,Mirage,14,19,33,0.42424242424242425
00NATION,Nuke,11,19,30,0.36666666666666664
00NATION,Overpass,14,15,29,0.4827586206896552
00NATION,Vertigo,4,8,12,0.3333333333333333
0to100,Ancient,1,0,1,1.0
0to100,Dust2,7,5,12,0.5833333333333334
0to100,Inferno,10,7,17,0.5882352941176471
0to100,Mirage,7,4,11,0.6363636363636364
0to100,Nuke,6,2,8,0.75
0to100,Overpass,0,1,1,0.0
0to100,Vertigo,1,2,3,0.3333333333333333
1 JIN,Ancient,2,1,3,0.6666666666666666
1 JIN,Inferno,2,4,6,0.3333333333333333
1 JIN,Mirage,6,1,7,0.8571428571428571
1 JIN,Overpass,2,1,3,0.6666666666666666
1 JIN,Vertigo,0,4,4,0.0
100PG,Ancient,1,3,4,0.25
100PG,Dust2,3,3,6,0.5
100PG,Inferno,4,6,10,0.4
100PG,Mirage,0,3,3,0.0
100PG,Nuke,2,2,4,0.5
100PG,Overpass,3,0,3,1.0
10org,Vertigo,0,1,1,0.0
123mix,Dust2,1,1,2,0.5
15 average Gang,Dust2,0,1,1,0.0
15 average Gang,Vertigo,0,1,1,0.0
1620 Kings,Ancient,1,3,4,0.25
1620 Kings,Dust2,5,4,9,0.5555555555555556
1620 Kings,Inferno,3,6,9,0.3333333333333333
1620 Kings,Nuke,3,3,6,0.5
1620 Kings,Overpass,3,0,3,1.0
1620 Kings,Vertigo,1,3,4,0.25
163ON,Ancient,2,3,5,0.4
163ON,Anubis,0,1,1,0.0
163ON,Dust2,0,1,1,0.0
163ON,Inferno,2,2,4,0.5
163ON,Mirage,6,3,9,0.6666666666666666
163ON,Nuke,1,0,1,1.0
163ON,Overpass,1,1,2,0.5
163ON,Vertigo,2,3,5,0.4
180mgkoffein,Ancient,1,0,1,1.0
180mgkoffein,Inferno,0,1,1,0.0
180mgkoffein,Mirage,0,2,2,0.0
180mgkoffein,Nuke,1,1,2,0.5
180mgkoffein,Overpass,1,1,2,0.5
1DayHeroes,Dust2,0,1,1,0.0
1DayHeroes,Mirage,0,1,1,0.0
1PIN,Ancient,9,2,11,0.8181818181818182
1PIN,Anubis,1,1,2,0.5
1PIN,Dust2,0,5,5,0.0
1PIN,Inferno,11,6,17,0.6470588235294118
1PIN,Mirage,2,6,8,0.25
1PIN,Overpass,2,8,10,0.2
1PIN,Vertigo,5,5,10,0.5
1WIN,Ancient,29,20,49,0.5918367346938775
1WIN,Dust2,29,19,48,0.6041666666666666
1WIN,Inferno,0,1,1,0.0
1WIN,Mirage,34,28,62,0.5483870967741935
1WIN,Nuke,46,25,71,0.647887323943662
1WIN,Overpass,29,24,53,0.5471698113207547
1WIN,Vertigo,47,23,70,0.6714285714285714
1fredde,Inferno,0,1,1,0.0
1fredde,Nuke,0,1,1,0.0
1shot,Ancient,1,5,6,0.16666666666666666
1shot,Dust2,11,3,14,0.7857142857142857
1shot,Inferno,12,10,22,0.5454545454545454
1shot,Mirage,16,11,27,0.5925925925925926
1shot,Nuke,21,8,29,0.7241379310344828
1shot,Overpass,2,8,10,0.2
1shot,Vertigo,3,9,12,0.25
2EASY,Nuke,0,1,1,0.0
2EASY,Overpass,0,1,1,0.0
4750mix,Ancient,0,1,1,0.0
4750mix,Mirage,0,1,1,0.0
4750mix,Nuke,1,0,1,1.0
4750mix,Overpass,0,1,1,0.0
4750mix,Vertigo,0,1,1,0.0
4Bots & Eric,Mirage,0,1,1,0.0
4Bots & Eric,Overpass,0,1,1,0.0
4Fun,Nuke,0,1,1,0.0
4ORMULA,Ancient,0,1,1,0.0
4ORMULA,Inferno,2,2,4,0.5
4ORMULA,Mirage,0,1,1,0.0
4ORMULA,Nuke,0,1,1,0.0
4ORMULA,Overpass,1,0,1,1.0
4ORMULA,Vertigo,1,1,2,0.5
4glory,Ancient,8,15,23,0.34782608695652173
4glory,Dust2,8,13,21,0.38095238095238093
4glory,Inferno,16,12,28,0.5714285714285714
4glory,Mirage,11,21,32,0.34375
4glory,Nuke,11,8,19,0.5789473684210527
4glory,Overpass,1,2,3,0.3333333333333333
4glory,Vertigo,8,8,16,0.5
500,Ancient,6,7,13,0.46153846153846156
500,Anubis,1,1,2,0.5
500,Dust2,3,2,5,0.6
500,Inferno,12,8,20,0.6
500,Mirage,9,8,17,0.5294117647058824
500,Nuke,7,8,15,0.4666666666666667
500,Overpass,19,10,29,0.6551724137931034
6'3 and Over,Overpass,2,0,2,1.0
6'3 and Over,Vertigo,1,0,1,1.0
727,Ancient,0,1,1,0.0
727,Dust2,1,1,2,0.5
727,Mirage,1,1,2,0.5
727,Nuke,0,1,1,0.0
777,Ancient,22,23,45,0.4888888888888889
777,Anubis,3,1,4,0.75
777,Dust2,11,16,27,0.4074074074074074
777,Inferno,3,8,11,0.2727272727272727
777,Mirage,12,26,38,0.3157894736842105
777,Nuke,15,19,34,0.4411764705882353
777,Overpass,34,27,61,0.5573770491803278
777,Vertigo,5,10,15,0.3333333333333333
7AM,Ancient,1,2,3,0.3333333333333333
7AM,Anubis,0,1,1,0.0
7AM,Dust2,0,2,2,0.0
7AM,Inferno,1,3,4,0.25
7AM,Nuke,2,2,4,0.5
7AM,Overpass,1,0,1,1.0
7AM,Vertigo,2,2,4,0.5
7AM NA,Ancient,0,3,3,0.0
7AM NA,Inferno,0,3,3,0.0
7AM NA,Mirage,0,4,4,0.0
7AM NA,Nuke,2,3,5,0.4
7AM NA,Overpass,1,0,1,1.0
8Ballers,Ancient,3,7,10,0.3
8Ballers,Dust2,3,5,8,0.375
8Ballers,Inferno,5,6,11,0.45454545454545453
8Ballers,Mirage,2,2,4,0.5
8Ballers,Nuke,4,9,13,0.3076923076923077
8Ballers,Overpass,1,1,2,0.5
8Ballers,Vertigo,7,5,12,0.5833333333333334
9 Pandas,Ancient,8,6,14,0.5714285714285714
9 Pandas,Anubis,0,1,1,0.0
9 Pandas,Dust2,4,1,5,0.8
9 Pandas,Inferno,4,5,9,0.4444444444444444
9 Pandas,Mirage,5,4,9,0.5555555555555556
9 Pandas,Nuke,3,5,8,0.375
9 Pandas,Overpass,7,6,13,0.5384615384615384
9 Pandas Fearless,Ancient,1,1,2,0.5
9 Pandas Fearless,Anubis,0,3,3,0.0
9 Pandas Fearless,Mirage,1,1,2,0.5
9 Pandas Fearless,Nuke,0,1,1,0.0
9 Pandas Fearless,Overpass,4,1,5,0.8
9 Pandas Fearless,Vertigo,2,0,2,1.0
95 Bulls,Overpass,0,1,1,0.0
9INE,Ancient,9,8,17,0.5294117647058824
9INE,Anubis,5,2,7,0.7142857142857143
9INE,Dust2,5,7,12,0.4166666666666667
9INE,Inferno,0,3,3,0.0
9INE,Mirage,25,17,42,0.5952380952380952
9INE,Nuke,14,6,20,0.7
9INE,Overpass,26,12,38,0.6842105263157895
9INE,Vertigo,19,13,32,0.59375
9INE Academy,Ancient,1,1,2,0.5
9INE Academy,Inferno,0,1,1,0.0
9INE Academy,Overpass,0,2,2,0.0
9INE Academy,Vertigo,0,2,2,0.0
9z,Ancient,19,15,34,0.5588235294117647
9z,Anubis,2,0,2,1.0
9z,Dust2,34,12,46,0.7391304347826086
9z,Inferno,23,17,40,0.575
9z,Mirage,26,18,44,0.5909090909090909
9z,Nuke,53,17,70,0.7571428571428571
9z,Overpass,21,13,34,0.6176470588235294
9z,Vertigo,1,0,1,1.0
9z Academy,Ancient,3,6,9,0.3333333333333333
9z Academy,Dust2,8,6,14,0.5714285714285714
9z Academy,Inferno,0,5,5,0.0
9z Academy,Mirage,0,3,3,0.0
9z Academy,Nuke,5,6,11,0.45454545454545453
9z Academy,Overpass,7,6,13,0.5384615384615384
9z Academy,Vertigo,4,4,8,0.5
ADAGIO,Dust2,1,0,1,1.0
ADAGIO,Inferno,1,2,3,0.3333333333333333
ADAGIO,Mirage,0,1,1,0.0
ADAGIO,Overpass,0,1,1,0.0
AFTERPARTY,Inferno,0,1,1,0.0
AFTERPARTY,Mirage,0,1,1,0.0
AFundaa,Mirage,0,1,1,0.0
AGF,Ancient,2,5,7,0.2857142857142857
AGF,Dust2,1,4,5,0.2
AGF,Inferno,9,6,15,0.6
AGF,Mirage,1,7,8,0.125
AGF,Nuke,9,9,18,0.5
AGF,Overpass,3,10,13,0.23076923076923078
AGF,Vertigo,4,5,9,0.4444444444444444
AGO,Ancient,40,26,66,0.6060606060606061
AGO,Dust2,22,19,41,0.5365853658536586
AGO,Inferno,23,26,49,0.46938775510204084
AGO,Mirage,28,25,53,0.5283018867924528
AGO,Nuke,13,19,32,0.40625
AGO,Overpass,3,10,13,0.23076923076923078
AGO,Vertigo,20,25,45,0.4444444444444444
AHJO,Nuke,0,1,1,0.0
AHJO,Vertigo,0,1,1,0.0
AIRLYA,Ancient,1,1,2,0.5
AIRLYA,Dust2,3,1,4,0.75
AIRLYA,Inferno,6,2,8,0.75
AIRLYA,Mirage,1,5,6,0.16666666666666666
AIRLYA,Nuke,0,1,1,0.0
AIRLYA,Vertigo,3,0,3,1.0
AJF,Ancient,0,1,1,0.0
AJF,Dust2,3,2,5,0.6
AJF,Inferno,0,1,1,0.0
AJF,Mirage,0,3,3,0.0
AJF,Nuke,1,1,2,0.5
AJF,Overpass,0,2,2,0.0
AJF,Vertigo,0,2,2,0.0
ALTERNATE aTTaX,Ancient,12,18,30,0.4
ALTERNATE aTTaX,Anubis,2,7,9,0.2222222222222222
ALTERNATE aTTaX,Dust2,7,8,15,0.4666666666666667
ALTERNATE aTTaX,Inferno,17,26,43,0.3953488372093023
ALTERNATE aTTaX,Mirage,7,13,20,0.35
ALTERNATE aTTaX,Nuke,3,6,9,0.3333333333333333
ALTERNATE aTTaX,Overpass,21,11,32,0.65625
ALTERNATE aTTaX,Vertigo,14,15,29,0.4827586206896552
ANDIBUL CARROT,Mirage,0,1,1,0.0
ANDROMEDA,Mirage,0,1,1,0.0
ANDROMEDA,Nuke,0,1,1,0.0
AQN,Mirage,0,1,1,0.0
AQN,Vertigo,1,0,1,1.0
ARAVT,Ancient,7,6,13,0.5384615384615384
ARAVT,Dust2,2,5,7,0.2857142857142857
ARAVT,Inferno,6,8,14,0.42857142857142855
ARAVT,Mirage,0,1,1,0.0
ARAVT,Nuke,4,6,10,0.4
ARAVT,Overpass,3,8,11,0.2727272727272727
ARAVT,Vertigo,3,5,8,0.375
ARCRED,Ancient,3,7,10,0.3
ARCRED,Inferno,3,3,6,0.5
ARCRED,Mirage,2,3,5,0.4
ARCRED,Nuke,2,2,4,0.5
ARCRED,Overpass,0,4,4,0.0
ARCRED,Vertigo,0,2,2,0.0
ARCTIC,Ancient,20,11,31,0.6451612903225806
ARCTIC,Anubis,0,1,1,0.0
ARCTIC,Dust2,16,7,23,0.6956521739130435
ARCTIC,Inferno,13,10,23,0.5652173913043478
ARCTIC,Mirage,2,4,6,0.3333333333333333
ARCTIC,Nuke,19,15,34,0.5588235294117647
ARCTIC,Overpass,13,4,17,0.7647058823529411
ARCTIC,Vertigo,4,4,8,0.5
ASG,Ancient,1,1,2,0.5
ASG,Dust2,0,2,2,0.0
ASG,Inferno,1,1,2,0.5
ASG,Mirage,0,1,1,0.0
ASG,Overpass,1,0,1,1.0
ASG,Vertigo,0,1,1,0.0
ATK,Ancient,21,14,35,0.6
ATK,Anubis,6,4,10,0.6
ATK,Dust2,23,13,36,0.6388888888888888
ATK,Inferno,51,46,97,0.5257731958762887
ATK,Mirage,58,28,86,0.6744186046511628
ATK,Nuke,9,19,28,0.32142857142857145
ATK,Overpass,28,33,61,0.45901639344262296
ATK,Vertigo,21,18,39,0.5384615384615384
ATK fe,Dust2,0,1,1,0.0
ATK fe,Inferno,0,3,3,0.0
ATK fe,Overpass,1,1,2,0.5
AUGPLAYRS,Inferno,0,1,1,0.0
AURA,Ancient,1,4,5,0.2
AURA,Dust2,2,1,3,0.6666666666666666
AURA,Inferno,5,4,9,0.5555555555555556
AURA,Mirage,5,7,12,0.4166666666666667
AURA,Overpass,10,3,13,0.7692307692307693
AURA,Vertigo,2,3,5,0.4
AURA UK,Dust2,0,1,1,0.0
AURA UK,Vertigo,0,1,1,0.0
AVA,Ancient,0,1,1,0.0
AVA,Dust2,0,2,2,0.0
AVA,Inferno,1,0,1,1.0
AVA,Overpass,0,1,1,0.0
AVADA KEDAVRA,Inferno,0,1,1,0.0
AVADA KEDAVRA,Mirage,0,1,1,0.0
AVADA KEDAVRA,Nuke,0,1,1,0.0
AVANGAR,Ancient,7,7,14,0.5
AVANGAR,Dust2,7,5,12,0.5833333333333334
AVANGAR,Inferno,8,13,21,0.38095238095238093
AVANGAR,Mirage,20,10,30,0.6666666666666666
AVANGAR,Nuke,3,6,9,0.3333333333333333
AVANGAR,Overpass,13,6,19,0.6842105263157895
AVANGAR,Vertigo,8,5,13,0.6153846153846154
AVE,Ancient,16,9,25,0.64
AVE,Dust2,7,3,10,0.7
AVE,Inferno,19,17,36,0.5277777777777778
AVE,Mirage,11,5,16,0.6875
AVE,Nuke,9,11,20,0.45
AVE,Overpass,9,8,17,0.5294117647058824
AVE,Vertigo,0,1,1,0.0
AVEZ,Ancient,2,2,4,0.5
AVEZ,Inferno,0,3,3,0.0
AVEZ,Mirage,2,3,5,0.4
AVEZ,Nuke,2,5,7,0.2857142857142857
AVEZ,Overpass,2,0,2,1.0
AVEZ,Vertigo,4,6,10,0.4
AWADEUWU,Overpass,0,1,1,0.0
AaB,Ancient,4,4,8,0.5
AaB,Dust2,0,3,3,0.0
AaB,Inferno,9,4,13,0.6923076923076923
AaB,Mirage,3,2,5,0.6
AaB,Nuke,3,4,7,0.42857142857142855
AaB,Overpass,4,5,9,0.4444444444444444
AaB,Train,1,0,1,1.0
AaB,Vertigo,0,3,3,0.0
After,Ancient,1,0,1,1.0
After,Dust2,0,1,1,0.0
After,Inferno,1,3,4,0.25
After,Mirage,1,1,2,0.5
After,Nuke,1,2,3,0.3333333333333333
After,Overpass,1,1,2,0.5
Aftershock,Ancient,0,1,1,0.0
Aftershock,Dust2,5,1,6,0.8333333333333334
Aftershock,Inferno,1,2,3,0.3333333333333333
Aftershock,Mirage,3,0,3,1.0
Aftershock,Nuke,1,2,3,0.3333333333333333
Aftershock,Overpass,2,2,4,0.5
Aftershock,Vertigo,1,3,4,0.25
Aiming is Difficult,Ancient,0,1,1,0.0
Aiming is Difficult,Dust2,1,0,1,1.0
Aiming is Difficult,Inferno,1,0,1,1.0
Aiming is Difficult,Overpass,0,1,1,0.0
AirBNB Incident,Ancient,1,0,1,1.0
AirBNB Incident,Inferno,1,1,2,0.5
AirBNB Incident,Mirage,0,1,1,0.0
AirBNB Incident,Overpass,1,0,1,1.0
AirBNB Incident,Vertigo,2,0,2,1.0
Akave,Inferno,0,1,1,0.0
Akave,Overpass,0,1,1,0.0
Akimbo,Dust2,1,0,1,1.0
Akimbo,Inferno,1,1,2,0.5
Akimbo,Nuke,1,0,1,1.0
Akimbo,Overpass,1,0,1,1.0
Akimbo,Vertigo,0,1,1,0.0
Akuma,Dust2,4,4,8,0.5
Akuma,Inferno,9,4,13,0.6923076923076923
Akuma,Mirage,3,7,10,0.3
Akuma,Nuke,4,6,10,0.4
Akuma,Overpass,3,3,6,0.5
Akuma,Vertigo,6,6,12,0.5
AlHilal,Dust2,1,0,1,1.0
AlHilal,Inferno,2,0,2,1.0
AlHilal,Mirage,0,2,2,0.0
AlHilal,Overpass,1,0,1,1.0
AlNasser,Dust2,0,1,1,0.0
AlNasser,Inferno,0,2,2,0.0
AlNasser,Mirage,2,0,2,1.0
AlNasser,Overpass,0,1,1,0.0
Alex Rider,Mirage,1,0,1,1.0
Alex Rider,Overpass,0,1,1,0.0
Alex Rider,Vertigo,0,1,1,0.0
Algeria,Dust2,0,1,1,0.0
Algeria,Inferno,0,1,1,0.0
Algeria,Mirage,0,1,1,0.0
Algeria,Vertigo,0,1,1,0.0
Alig.b,Inferno,0,1,1,0.0
Alig.b,Mirage,0,1,1,0.0
Alke,Ancient,2,6,8,0.25
Alke,Dust2,2,0,2,1.0
Alke,Inferno,0,2,2,0.0
Alke,Mirage,3,5,8,0.375
Alke,Nuke,4,8,12,0.3333333333333333
Alke,Overpass,2,2,4,0.5
Alke,Vertigo,4,7,11,0.36363636363636365
All Gas No Brakes,Ancient,0,1,1,0.0
All Gas No Brakes,Dust2,2,2,4,0.5
All Gas No Brakes,Inferno,0,2,2,0.0
All Gas No Brakes,Mirage,0,3,3,0.0
All Gas No Brakes,Nuke,0,1,1,0.0
All Gas No Brakes,Overpass,1,0,1,1.0
All Gas No Brakes,Vertigo,0,1,1,0.0
Aloha,Dust2,1,0,1,1.0
Aloha,Inferno,1,0,1,1.0
Alpha,Dust2,1,1,2,0.5
Alpha,Inferno,1,1,2,0.5
Alpha,Mirage,0,1,1,0.0
Ambush,Ancient,2,10,12,0.16666666666666666
Ambush,Dust2,4,5,9,0.4444444444444444
Ambush,Inferno,12,12,24,0.5
Ambush,Mirage,1,4,5,0.2
Ambush,Nuke,2,4,6,0.3333333333333333
Ambush,Overpass,0,3,3,0.0
Ambush,Vertigo,6,8,14,0.42857142857142855
Ambush fe,Dust2,0,1,1,0.0
Ambush fe,Mirage,1,0,1,1.0
Ambush fe,Overpass,1,0,1,1.0
Angels,Mirage,0,1,1,0.0
Angels,Overpass,0,1,1,0.0
Animal Squad,Ancient,0,1,1,0.0
Animal Squad,Inferno,1,1,2,0.5
Animal Squad,Nuke,0,1,1,0.0
Animal Squad,Overpass,0,1,1,0.0
Animal Squad,Vertigo,0,1,1,0.0
AnimeSubmarine,Ancient,0,1,1,0.0
AnimeSubmarine,Vertigo,0,1,1,0.0
Anlaki,Ancient,2,0,2,1.0
Anlaki,Dust2,1,0,1,1.0
Anlaki,Inferno,1,2,3,0.3333333333333333
Anlaki,Mirage,1,0,1,1.0
Anlaki,Nuke,0,1,1,0.0
Anlaki,Overpass,1,1,2,0.5
Anlaki,Vertigo,0,1,1,0.0
Anonymo,Ancient,23,31,54,0.42592592592592593
Anonymo,Anubis,2,2,4,0.5
Anonymo,Dust2,11,19,30,0.36666666666666664
Anonymo,Inferno,13,13,26,0.5
Anonymo,Mirage,27,29,56,0.48214285714285715
Anonymo,Nuke,20,31,51,0.39215686274509803
Anonymo,Overpass,21,19,40,0.525
Anonymo,Vertigo,26,19,45,0.5777777777777777
Antarctica,Inferno,0,1,1,0.0
Antarctica,Nuke,0,1,1,0.0
Antic,Ancient,3,2,5,0.6
Antic,Dust2,5,3,8,0.625
Antic,Inferno,6,8,14,0.42857142857142855
Antic,Mirage,6,7,13,0.46153846153846156
Antic,Nuke,4,5,9,0.4444444444444444
Antic,Overpass,4,6,10,0.4
Antic,Vertigo,12,7,19,0.631578947368421
Aorus Vision,Ancient,0,1,1,0.0
Aorus Vision,Inferno,1,0,1,1.0
Aorus Vision,Nuke,0,2,2,0.0
Aorus Vision,Overpass,0,1,1,0.0
AotC,Inferno,2,0,2,1.0
AotC,Mirage,2,0,2,1.0
AotC,Overpass,0,1,1,0.0
Ape Gang,Dust2,1,2,3,0.3333333333333333
Ape Gang,Inferno,3,0,3,1.0
Ape Gang,Mirage,1,2,3,0.3333333333333333
Ape Gang,Nuke,0,1,1,0.0
Apeks,Ancient,24,24,48,0.5
Apeks,Anubis,8,2,10,0.8
Apeks,Dust2,16,17,33,0.48484848484848486
Apeks,Inferno,35,27,62,0.5645161290322581
Apeks,Mirage,38,22,60,0.6333333333333333
Apeks,Nuke,21,23,44,0.4772727272727273
Apeks,Overpass,40,21,61,0.6557377049180327
Apeks,Vertigo,11,12,23,0.4782608695652174
Apeks Legends,Ancient,1,1,2,0.5
Apeks Legends,Inferno,2,2,4,0.5
Apeks Legends,Mirage,1,1,2,0.5
Apeks Legends,Overpass,1,2,3,0.3333333333333333
Apeks Rebels,Ancient,7,12,19,0.3684210526315789
Apeks Rebels,Anubis,0,2,2,0.0
Apeks Rebels,Dust2,1,4,5,0.2
Apeks Rebels,Inferno,10,12,22,0.45454545454545453
Apeks Rebels,Mirage,4,12,16,0.25
Apeks Rebels,Nuke,6,4,10,0.6
Apeks Rebels,Overpass,14,13,27,0.5185185185185185
Apeks Rebels,Vertigo,8,11,19,0.42105263157894735
Apocalypse,Ancient,0,2,2,0.0
Apocalypse,Inferno,0,3,3,0.0
Apocalypse,Mirage,1,2,3,0.3333333333333333
Apocalypse,Nuke,0,2,2,0.0
Apocalypse,Overpass,0,2,2,0.0
Arctic,Dust2,1,0,1,1.0
Arctic,Inferno,1,0,1,1.0
Arctic,Mirage,0,1,1,0.0
Arctic,Nuke,0,1,1,0.0
Arctic,Overpass,0,1,1,0.0
Arctic Raptors,Ancient,1,2,3,0.3333333333333333
Arctic Raptors,Inferno,1,1,2,0.5
Arctic Raptors,Nuke,0,1,1,0.0
Area51,Ancient,1,0,1,1.0
Area51,Inferno,1,0,1,1.0
Area51,Mirage,0,1,1,0.0
Area51,Vertigo,1,0,1,1.0
Arena,Dust2,1,1,2,0.5
Arena,Inferno,2,2,4,0.5
Arena,Mirage,1,2,3,0.3333333333333333
Arena,Nuke,1,1,2,0.5
Arena,Vertigo,0,3,3,0.0
Argentina,Ancient,0,1,1,0.0
Argentina,Dust2,2,1,3,0.6666666666666666
Argentina,Mirage,1,2,3,0.3333333333333333
Argentina fe,Ancient,0,1,1,0.0
Argentina fe,Mirage,0,1,1,0.0
Argon,Ancient,1,0,1,1.0
Argon,Mirage,0,2,2,0.0
Argon,Vertigo,0,2,2,0.0
Arvum,Ancient,1,2,3,0.3333333333333333
Arvum,Dust2,3,2,5,0.6
Arvum,Inferno,3,1,4,0.75
Arvum,Mirage,3,6,9,0.3333333333333333
Arvum,Nuke,3,3,6,0.5
Arvum,Overpass,3,2,5,0.6
Aseris,Dust2,1,0,1,1.0
Aseris,Mirage,0,1,1,0.0
Aseris,Vertigo,0,1,1,0.0
Asterys,Ancient,0,1,1,0.0
Asterys,Dust2,0,1,1,0.0
Asterys,Inferno,0,2,2,0.0
Asterys,Nuke,0,1,1,0.0
Asterys,Overpass,0,1,1,0.0
Astralis,Ancient,27,18,45,0.6
Astralis,Dust2,17,18,35,0.4857142857142857
Astralis,Inferno,25,18,43,0.5813953488372093
Astralis,Mirage,22,23,45,0.4888888888888889
Astralis,Nuke,38,30,68,0.5588235294117647
Astralis,Overpass,23,18,41,0.5609756097560976
Astralis,Vertigo,9,12,21,0.42857142857142855
Astralis Talent,Ancient,22,9,31,0.7096774193548387
Astralis Talent,Anubis,2,6,8,0.25
Astralis Talent,Dust2,1,4,5,0.2
Astralis Talent,Inferno,19,18,37,0.5135135135135135
Astralis Talent,Mirage,17,24,41,0.4146341463414634
Astralis Talent,Nuke,13,14,27,0.48148148148148145
Astralis Talent,Overpass,19,25,44,0.4318181818181818
Astralis Talent,Vertigo,31,27,58,0.5344827586206896
Astralis fe,Ancient,0,1,1,0.0
Astralis fe,Mirage,0,1,1,0.0
Astralis fe,Overpass,0,2,2,0.0
Atlantic,Ancient,4,1,5,0.8
Atlantic,Anubis,0,1,1,0.0
Atlantic,Dust2,0,5,5,0.0
Atlantic,Inferno,4,8,12,0.3333333333333333
Atlantic,Mirage,2,2,4,0.5
Atlantic,Nuke,4,1,5,0.8
Atlantic,Overpass,4,1,5,0.8
Atlantic,Vertigo,4,5,9,0.4444444444444444
Atlantiss,Inferno,0,1,1,0.0
Aurora,Ancient,6,5,11,0.5454545454545454
Aurora,Anubis,6,1,7,0.8571428571428571
Aurora,Dust2,3,2,5,0.6
Aurora,Inferno,6,2,8,0.75
Aurora,Mirage,12,11,23,0.5217391304347826
Aurora,Nuke,14,3,17,0.8235294117647058
Aurora,Overpass,9,8,17,0.5294117647058824
Aurora,Vertigo,3,5,8,0.375
Australs,Dust2,0,2,2,0.0
Australs,Mirage,0,1,1,0.0
Australs,Nuke,0,3,3,0.0
Austria,Dust2,1,0,1,1.0
Austria,Inferno,1,2,3,0.3333333333333333
Austria,Mirage,0,3,3,0.0
Austria,Nuke,0,1,1,0.0
Austria,Overpass,0,2,2,0.0
Austria,Vertigo,0,1,1,0.0
Axolotls,Ancient,2,2,4,0.5
Axolotls,Dust2,2,1,3,0.6666666666666666
Axolotls,Inferno,1,2,3,0.3333333333333333
Axolotls,Mirage,2,4,6,0.3333333333333333
Axolotls,Overpass,1,2,3,0.3333333333333333
Axolotls,Vertigo,3,4,7,0.42857142857142855
AzerbejdzanPL,Ancient,1,0,1,1.0
AzerbejdzanPL,Inferno,1,0,1,1.0
AzerbejdzanPL,Mirage,1,0,1,1.0
AzerbejdzanPL,Nuke,0,1,1,0.0
B4,Ancient,11,4,15,0.7333333333333333
B4,Dust2,12,12,24,0.5
B4,Inferno,7,4,11,0.6363636363636364
B4,Mirage,13,5,18,0.7222222222222222
B4,Nuke,8,6,14,0.5714285714285714
B4,Overpass,4,3,7,0.5714285714285714
B4,Vertigo,6,5,11,0.5454545454545454
B4 Academy,Ancient,0,2,2,0.0
B4 Academy,Dust2,1,4,5,0.2
B4 Academy,Inferno,0,1,1,0.0
B4 Academy,Mirage,3,3,6,0.5
B4 Academy,Nuke,1,2,3,0.3333333333333333
B4 fe,Ancient,2,0,2,1.0
B4 fe,Anubis,0,2,2,0.0
B4 fe,Dust2,2,2,4,0.5
B4 fe,Inferno,2,2,4,0.5
B4 fe,Nuke,2,2,4,0.5
B4 fe,Overpass,1,0,1,1.0
B4 fe,Vertigo,2,3,5,0.4
B8,Ancient,8,12,20,0.4
B8,Dust2,12,12,24,0.5
B8,Inferno,9,9,18,0.5
B8,Mirage,7,8,15,0.4666666666666667
B8,Nuke,24,12,36,0.6666666666666666
B8,Overpass,5,7,12,0.4166666666666667
B8,Vertigo,14,14,28,0.5
BAZA,Overpass,1,0,1,1.0
BAZA,Vertigo,1,0,1,1.0
BEBRA,Ancient,1,2,3,0.3333333333333333
BEBRA,Dust2,0,2,2,0.0
BEBRA,Inferno,1,1,2,0.5
BEBRA,Mirage,2,1,3,0.6666666666666666
BEBRA,Nuke,0,5,5,0.0
BEBRA,Overpass,2,0,2,1.0
BEE,Dust2,1,1,2,0.5
BEE,Inferno,3,1,4,0.75
BEE,Mirage,1,3,4,0.25
BEE,Nuke,1,0,1,1.0
BEE,Overpass,0,3,3,0.0
BEE,Vertigo,1,1,2,0.5
BESTIA,Ancient,1,0,1,1.0
BESTIA,Anubis,1,0,1,1.0
BESTIA,Inferno,2,0,2,1.0
BESTIA,Mirage,1,0,1,1.0
BESTIA,Nuke,1,0,1,1.0
BESTIA,Overpass,2,0,2,1.0
BEZ ZP,Ancient,0,3,3,0.0
BEZ ZP,Dust2,2,2,4,0.5
BEZ ZP,Inferno,1,2,3,0.3333333333333333
BEZ ZP,Mirage,2,0,2,1.0
BEZ ZP,Nuke,1,1,2,0.5
BEZ ZP,Overpass,3,1,4,0.75
BHOP,Ancient,4,4,8,0.5
BHOP,Dust2,6,8,14,0.42857142857142855
BHOP,Inferno,16,16,32,0.5
BHOP,Mirage,9,7,16,0.5625
BHOP,Nuke,8,7,15,0.5333333333333333
BHOP,Overpass,5,11,16,0.3125
BHOP,Vertigo,10,2,12,0.8333333333333334
BIG,Ancient,8,12,20,0.4
BIG,Anubis,2,4,6,0.3333333333333333
BIG,Dust2,41,23,64,0.640625
BIG,Inferno,15,19,34,0.4411764705882353
BIG,Mirage,30,27,57,0.5263157894736842
BIG,Nuke,25,30,55,0.45454545454545453
BIG,Overpass,12,15,27,0.4444444444444444
BIG,Vertigo,12,15,27,0.4444444444444444
BIG Academy,Ancient,6,15,21,0.2857142857142857
BIG Academy,Anubis,3,2,5,0.6
BIG Academy,Dust2,20,13,33,0.6060606060606061
BIG Academy,Inferno,13,19,32,0.40625
BIG Academy,Mirage,25,27,52,0.4807692307692308
BIG Academy,Nuke,10,16,26,0.38461538461538464
BIG Academy,Overpass,31,10,41,0.7560975609756098
BIG Academy,Vertigo,25,21,46,0.5434782608695652
BIG EQUIPA,Ancient,2,1,3,0.6666666666666666
BIG EQUIPA,Anubis,1,0,1,1.0
BIG EQUIPA,Dust2,2,0,2,1.0
BIG EQUIPA,Inferno,1,2,3,0.3333333333333333
BIG EQUIPA,Mirage,1,0,1,1.0
BIG EQUIPA,Nuke,0,2,2,0.0
BIG EQUIPA,Overpass,1,3,4,0.25
BIG EQUIPA,Vertigo,0,2,2,0.0
BIGODES,Nuke,1,1,2,0.5
BIGODES,Overpass,1,1,2,0.5
BIICEPS,Inferno,0,2,2,0.0
BIICEPS,Mirage,1,0,1,1.0
BIICEPS,Nuke,1,1,2,0.5
BIICEPS,Overpass,0,1,1,0.0
BIOS,Mirage,1,1,2,0.5
BIOS,Nuke,1,0,1,1.0
BIOS,Overpass,1,3,4,0.25
BIOS,Vertigo,0,2,2,0.0
BLINK,Ancient,15,17,32,0.46875
BLINK,Anubis,0,2,2,0.0
BLINK,Dust2,11,16,27,0.4074074074074074
BLINK,Inferno,30,22,52,0.5769230769230769
BLINK,Mirage,32,17,49,0.6530612244897959
BLINK,Nuke,2,10,12,0.16666666666666666
BLINK,Overpass,8,17,25,0.32
BLINK,Vertigo,18,20,38,0.47368421052631576
BLUEJAYS,Ancient,19,26,45,0.4222222222222222
BLUEJAYS,Anubis,3,1,4,0.75
BLUEJAYS,Dust2,33,22,55,0.6
BLUEJAYS,Inferno,50,38,88,0.5681818181818182
BLUEJAYS,Mirage,78,42,120,0.65
BLUEJAYS,Nuke,2,9,11,0.18181818181818182
BLUEJAYS,Overpass,18,24,42,0.42857142857142855
BLUEJAYS,Vertigo,28,27,55,0.509090909090909
BLVKHVND,Ancient,1,2,3,0.3333333333333333
BLVKHVND,Dust2,7,2,9,0.7777777777777778
BLVKHVND,Inferno,3,1,4,0.75
BLVKHVND,Mirage,1,2,3,0.3333333333333333
BLVKHVND,Nuke,3,3,6,0.5
BLVKHVND,Overpass,2,2,4,0.5
BLVKHVND,Vertigo,3,4,7,0.42857142857142855
BNR,Inferno,0,1,1,0.0
BNR,Mirage,1,0,1,1.0
BNR,Overpass,0,1,1,0.0
BOOMSHAKE,Dust2,1,0,1,1.0
BOOMSHAKE,Inferno,1,0,1,1.0
BOOMSHAKE,Mirage,0,1,1,0.0
BOOMSHAKE,Vertigo,0,1,1,0.0
BOOZOOMERS,Inferno,1,0,1,1.0
BOOZOOMERS,Mirage,0,1,1,0.0
BOOZOOMERS,Overpass,0,1,1,0.0
BTH,Ancient,0,1,1,0.0
BTH,Dust2,0,1,1,0.0
BTH,Inferno,0,1,1,0.0
BTH,Vertigo,0,1,1,0.0
BUDI2,Inferno,0,1,1,0.0
BUDI2,Overpass,0,1,1,0.0
Babos,Ancient,1,1,2,0.5
Babos,Anubis,0,1,1,0.0
Babos,Dust2,1,3,4,0.25
Babos,Inferno,3,4,7,0.42857142857142855
Babos,Mirage,4,2,6,0.6666666666666666
Babos,Overpass,2,3,5,0.4
Babos,Vertigo,2,3,5,0.4
Bad News Bears,Ancient,10,12,22,0.45454545454545453
Bad News Bears,Dust2,24,13,37,0.6486486486486487
Bad News Bears,Inferno,23,24,47,0.48936170212765956
Bad News Bears,Mirage,15,18,33,0.45454545454545453
Bad News Bears,Nuke,23,18,41,0.5609756097560976
Bad News Bears,Overpass,26,18,44,0.5909090909090909
Bad News Bears,Vertigo,0,1,1,0.0
Bad News Eagles,Ancient,25,15,40,0.625
Bad News Eagles,Anubis,2,2,4,0.5
Bad News Eagles,Dust2,11,7,18,0.6111111111111112
Bad News Eagles,Inferno,19,10,29,0.6551724137931034
Bad News Eagles,Mirage,25,15,40,0.625
Bad News Eagles,Nuke,6,12,18,0.3333333333333333
Bad News Eagles,Overpass,2,4,6,0.3333333333333333
Bad News Eagles,Vertigo,12,14,26,0.46153846153846156
BakS,Anubis,1,0,1,1.0
BakS,Inferno,0,3,3,0.0
BakS,Mirage,2,2,4,0.5
BakS,Nuke,0,2,2,0.0
BakS,Overpass,0,1,1,0.0
BakS,Vertigo,3,0,3,1.0
Bandaleros,Inferno,0,1,1,0.0
Bandaleros,Mirage,0,1,1,0.0
Bandits,Ancient,1,0,1,1.0
Bandits,Dust2,0,3,3,0.0
Bandits,Inferno,4,5,9,0.4444444444444444
Bandits,Mirage,5,2,7,0.7142857142857143
Bandits,Nuke,0,1,1,0.0
Bandits,Overpass,0,2,2,0.0
Bandits,Vertigo,2,4,6,0.3333333333333333
Bco,Inferno,0,1,1,0.0
Bco,Mirage,0,1,1,0.0
Bco,Overpass,0,1,1,0.0
Bears,Ancient,0,2,2,0.0
Bears,Inferno,0,1,1,0.0
Bears,Overpass,0,1,1,0.0
Bears,Vertigo,0,1,1,0.0
Bears Concept,Nuke,0,2,2,0.0
Bears Concept,Vertigo,0,1,1,0.0
Belgium,Inferno,0,1,1,0.0
Belgium,Mirage,0,2,2,0.0
Belgium,Nuke,0,2,2,0.0
Believe,Ancient,0,1,1,0.0
Believe,Vertigo,0,1,1,0.0
Believeee,Inferno,1,1,2,0.5
Believeee,Mirage,1,0,1,1.0
Believeee,Overpass,0,1,1,0.0
Believeee,Vertigo,1,0,1,1.0
Benched Heroes,Ancient,0,3,3,0.0
Benched Heroes,Dust2,1,1,2,0.5
Benched Heroes,Inferno,1,0,1,1.0
Benched Heroes,Mirage,1,2,3,0.3333333333333333
Benched Heroes,Nuke,1,0,1,1.0
Benched Heroes,Overpass,2,1,3,0.6666666666666666
Benched Heroes,Vertigo,1,0,1,1.0
Berzerk,Ancient,0,1,1,0.0
Berzerk,Mirage,0,1,1,0.0
Berzerk,Overpass,1,0,1,1.0
Beyond Possible,Ancient,3,5,8,0.375
Beyond Possible,Anubis,2,0,2,1.0
Beyond Possible,Dust2,3,2,5,0.6
Beyond Possible,Inferno,5,6,11,0.45454545454545453
Beyond Possible,Mirage,1,5,6,0.16666666666666666
Beyond Possible,Nuke,2,3,5,0.4
Beyond Possible,Overpass,4,3,7,0.5714285714285714
Big 5,Inferno,0,1,1,0.0
Big 5,Mirage,0,1,1,0.0
Big 5,Overpass,1,0,1,1.0
Big Chillin,Ancient,2,2,4,0.5
Big Chillin,Dust2,2,14,16,0.125
Big Chillin,Inferno,3,12,15,0.2
Big Chillin,Mirage,1,5,6,0.16666666666666666
Big Chillin,Nuke,1,3,4,0.25
Big Chillin,Overpass,3,5,8,0.375
Big Chillin,Vertigo,5,6,11,0.45454545454545453
Big City Blues,Mirage,0,1,1,0.0
Big City Blues,Nuke,1,1,2,0.5
Big City Blues,Overpass,1,0,1,1.0
BigD,Ancient,1,1,2,0.5
BigD,Dust2,0,1,1,0.0
BigD,Inferno,1,0,1,1.0
BigD,Mirage,1,0,1,1.0
BigRigger,Vertigo,0,1,1,0.0
Billionaires,Ancient,0,1,1,0.0
Billionaires,Inferno,1,0,1,1.0
Billionaires,Mirage,1,1,2,0.5
Billionaires,Overpass,0,1,1,0.0
Bitfix,Ancient,0,3,3,0.0
Bitfix,Inferno,2,1,3,0.6666666666666666
Bitfix,Mirage,1,0,1,1.0
Bitfix,Overpass,0,3,3,0.0
Bitfix,Vertigo,1,3,4,0.25
Black Dragons,Ancient,1,1,2,0.5
Black Dragons,Dust2,6,6,12,0.5
Black Dragons,Inferno,3,12,15,0.2
Black Dragons,Mirage,3,4,7,0.42857142857142855
Black Dragons,Nuke,3,4,7,0.42857142857142855
Black Dragons,Overpass,2,8,10,0.2
Black Dragons,Vertigo,2,1,3,0.6666666666666666
Black Dragons fe,Dust2,3,5,8,0.375
Black Dragons fe,Inferno,2,1,3,0.6666666666666666
Black Dragons fe,Mirage,1,4,5,0.2
Black Dragons fe,Nuke,2,4,6,0.3333333333333333
Black Dragons fe,Overpass,1,3,4,0.25
Black Pearl,Anubis,0,1,1,0.0
Blackhat,Dust2,1,1,2,0.5
Blackhat,Overpass,0,1,1,0.0
Blade Community,Ancient,0,1,1,0.0
Blade Community,Nuke,0,1,1,0.0
Bob,Ancient,0,1,1,0.0
Bob,Inferno,1,0,1,1.0
Bob,Mirage,0,1,1,0.0
Bob,Nuke,1,1,2,0.5
Bob,Vertigo,0,1,1,0.0
Boca Juniors,Ancient,8,10,18,0.4444444444444444
Boca Juniors,Anubis,1,1,2,0.5
Boca Juniors,Dust2,7,13,20,0.35
Boca Juniors,Inferno,19,23,42,0.4523809523809524
Boca Juniors,Mirage,5,14,19,0.2631578947368421
Boca Juniors,Nuke,12,20,32,0.375
Boca Juniors,Overpass,5,10,15,0.3333333333333333
Boca Juniors,Vertigo,8,5,13,0.6153846153846154
Born in Mongolia,Inferno,0,1,1,0.0
Born in Mongolia,Mirage,1,3,4,0.25
Born in Mongolia,Nuke,0,2,2,0.0
Born in Mongolia,Vertigo,0,1,1,0.0
Born in the East,Mirage,0,2,2,0.0
Born in the East,Nuke,1,0,1,1.0
Born in the East,Vertigo,1,2,3,0.3333333333333333
Bosnia & Herzegovina,Mirage,0,1,1,0.0
Bosnia & Herzegovina,Vertigo,0,1,1,0.0
Boston crab,Ancient,2,1,3,0.6666666666666666
Boston crab,Inferno,1,0,1,1.0
Boston crab,Mirage,2,4,6,0.3333333333333333
Boston crab,Nuke,2,1,3,0.6666666666666666
Boston crab,Overpass,6,0,6,1.0
Boston crab,Vertigo,1,2,3,0.3333333333333333
Boys without Pyjamas,Ancient,1,0,1,1.0
Boys without Pyjamas,Inferno,0,1,1,0.0
Boys without Pyjamas,Mirage,1,0,1,1.0
Boys without Pyjamas,Vertigo,0,1,1,0.0
Brandbergen Shooters,Inferno,0,2,2,0.0
Brandbergen Shooters,Mirage,0,1,1,0.0
Brandbergen Shooters,Overpass,1,0,1,1.0
Bravado,Ancient,1,0,1,1.0
Bravado,Dust2,5,5,10,0.5
Bravado,Inferno,6,6,12,0.5
Bravado,Mirage,7,5,12,0.5833333333333334
Bravado,Nuke,3,6,9,0.3333333333333333
Bravado,Overpass,1,1,2,0.5
Bravado,Vertigo,1,2,3,0.3333333333333333
Bravos,Ancient,12,5,17,0.7058823529411765
Bravos,Dust2,17,8,25,0.68
Bravos,Inferno,10,4,14,0.7142857142857143
Bravos,Nuke,17,10,27,0.6296296296296297
Bravos,Overpass,12,8,20,0.6
Bravos,Vertigo,6,2,8,0.75
Brazen,Ancient,1,7,8,0.125
Brazen,Dust2,0,8,8,0.0
Brazen,Inferno,4,9,13,0.3076923076923077
Brazen,Mirage,12,9,21,0.5714285714285714
Brazen,Nuke,7,12,19,0.3684210526315789
Brazen,Overpass,8,7,15,0.5333333333333333
Brazen,Vertigo,2,1,3,0.6666666666666666
Brazil,Train,1,0,1,1.0
Brigada,Mirage,0,1,1,0.0
Brigada,Overpass,0,1,1,0.0
Brosskiez,Ancient,1,3,4,0.25
Brosskiez,Dust2,2,1,3,0.6666666666666666
Brosskiez,Inferno,3,5,8,0.375
Brosskiez,Mirage,1,1,2,0.5
Brosskiez,Nuke,0,1,1,0.0
Brosskiez,Vertigo,3,1,4,0.75
BrГёndby,Ancient,0,1,1,0.0
BrГёndby,Nuke,0,2,2,0.0
BrГёndby,Overpass,1,0,1,1.0
BrГёndby,Vertigo,0,2,2,0.0
Budapest Five,Ancient,3,2,5,0.6
Budapest Five,Dust2,3,8,11,0.2727272727272727
Budapest Five,Inferno,9,9,18,0.5
Budapest Five,Mirage,12,12,24,0.5
Budapest Five,Nuke,5,3,8,0.625
Budapest Five,Overpass,4,7,11,0.36363636363636365
Budapest Five,Vertigo,3,4,7,0.42857142857142855
Bulgaria,Dust2,1,0,1,1.0
Bulgaria,Inferno,0,1,1,0.0
Bulgaria,Mirage,1,0,1,1.0
Bulgaria,Overpass,1,1,2,0.5
CAMO,Ancient,2,2,4,0.5
CAMO,Dust2,0,6,6,0.0
CAMO,Inferno,1,7,8,0.125
CAMO,Mirage,0,1,1,0.0
CAMO,Nuke,3,3,6,0.5
CAMO,Overpass,1,2,3,0.3333333333333333
CAMO,Vertigo,0,1,1,0.0
CARECAS,Ancient,0,1,1,0.0
CARECAS,Anubis,0,1,1,0.0
CARECAS,Nuke,0,1,1,0.0
CAT,Overpass,0,1,1,0.0
CCO,Ancient,1,2,3,0.3333333333333333
CCO,Dust2,4,1,5,0.8
CCO,Inferno,0,1,1,0.0
CCO,Nuke,0,1,1,0.0
CCO,Overpass,1,0,1,1.0
CCO,Vertigo,1,1,2,0.5
CENSRD,Dust2,0,1,1,0.0
CENSRD,Inferno,1,1,2,0.5
CENSRD,Nuke,1,3,4,0.25
CENSRD,Overpass,0,1,1,0.0
CENSRD,Vertigo,1,0,1,1.0
CENTER,Ancient,0,1,1,0.0
CENTER,Dust2,0,1,1,0.0
CENTER,Mirage,0,1,1,0.0
CENTER,Nuke,0,1,1,0.0
CEPTER,Ancient,1,1,2,0.5
CEPTER,Dust2,2,1,3,0.6666666666666666
CEPTER,Inferno,4,4,8,0.5
CEPTER,Mirage,1,2,3,0.3333333333333333
CEPTER,Nuke,3,6,9,0.3333333333333333
CEPTER,Overpass,1,2,3,0.3333333333333333
CEPTER,Vertigo,0,2,2,0.0
CLG Red,Ancient,1,1,2,0.5
CLG Red,Dust2,2,2,4,0.5
CLG Red,Inferno,4,2,6,0.6666666666666666
CLG Red,Mirage,8,4,12,0.6666666666666666
CLG Red,Nuke,0,1,1,0.0
CLG Red,Overpass,10,1,11,0.9090909090909091
CLG Red,Vertigo,4,2,6,0.6666666666666666
CNCS,Inferno,0,1,1,0.0
CNCS,Mirage,0,1,1,0.0
CNCS,Nuke,0,1,1,0.0
CNCS,Vertigo,0,1,1,0.0
CNCS LastHope,Mirage,0,1,1,0.0
CNCS LastHope,Nuke,0,1,1,0.0
COUSCOUS,Ancient,0,1,1,0.0
COUSCOUS,Inferno,1,0,1,1.0
COUSCOUS,Vertigo,0,1,1,0.0
COWABUNGA,Inferno,0,1,1,0.0
COWABUNGA,Nuke,0,1,1,0.0
CPH Flames fe,Ancient,1,0,1,1.0
CPH Flames fe,Inferno,1,0,1,1.0
CPH Flames fe,Mirage,0,2,2,0.0
CPH Flames fe,Overpass,1,0,1,1.0
CPH Flames fe,Vertigo,0,1,1,0.0
CR,Ancient,2,0,2,1.0
CR,Inferno,0,1,1,0.0
CR,Mirage,0,1,1,0.0
CR,Nuke,0,1,1,0.0
CR,Overpass,0,1,1,0.0
CRONEM,Mirage,1,0,1,1.0
CRONEM,Nuke,1,0,1,1.0
CYBER,Ancient,0,1,1,0.0
CYBER,Nuke,0,2,2,0.0
CYBER,Overpass,0,1,1,0.0
Camel Riders,Dust2,0,1,1,0.0
Camel Riders,Inferno,1,1,2,0.5
Camel Riders,Mirage,0,1,1,0.0
Camel Riders,Nuke,1,0,1,1.0
Camel Riders,Overpass,0,1,1,0.0
Capivara Strong,Dust2,0,1,1,0.0
Capivara Strong,Inferno,1,1,2,0.5
Capivara Strong,Mirage,2,0,2,1.0
Capivara Strong,Vertigo,0,1,1,0.0
Captain Cook,Ancient,0,1,1,0.0
Captain Cook,Dust2,1,0,1,1.0
Captain Cook,Inferno,0,2,2,0.0
Captain Cook,Vertigo,1,0,1,1.0
Capybara,Inferno,0,1,1,0.0
Capybara,Vertigo,0,1,1,0.0
Carpe Diem,Dust2,4,6,10,0.4
Carpe Diem,Inferno,15,9,24,0.625
Carpe Diem,Mirage,9,3,12,0.75
Carpe Diem,Nuke,6,5,11,0.5454545454545454
Carpe Diem,Overpass,14,12,26,0.5384615384615384
Carpe Diem,Vertigo,6,6,12,0.5
Cartel terraza,Ancient,1,4,5,0.2
Cartel terraza,Inferno,0,1,1,0.0
Cartel terraza,Mirage,0,3,3,0.0
Cartel terraza,Nuke,0,2,2,0.0
Cartel terraza,Overpass,2,0,2,1.0
Case,Ancient,1,4,5,0.2
Case,Anubis,2,2,4,0.5
Case,Dust2,2,1,3,0.6666666666666666
Case,Inferno,10,12,22,0.45454545454545453
Case,Mirage,4,9,13,0.3076923076923077
Case,Nuke,2,5,7,0.2857142857142857
Case,Overpass,7,3,10,0.7
Case,Vertigo,2,4,6,0.3333333333333333
CatEvil,Ancient,0,2,2,0.0
CatEvil,Dust2,2,2,4,0.5
CatEvil,Inferno,4,9,13,0.3076923076923077
CatEvil,Mirage,1,1,2,0.5
CatEvil,Nuke,5,6,11,0.45454545454545453
CatEvil,Overpass,0,1,1,0.0
Catchii,Nuke,0,1,1,0.0
Catchii,Overpass,0,1,1,0.0
Catchii,Vertigo,1,0,1,1.0
Caught off Guard,Dust2,3,3,6,0.5
Caught off Guard,Inferno,3,6,9,0.3333333333333333
Caught off Guard,Mirage,1,5,6,0.16666666666666666
Caught off Guard,Nuke,2,4,6,0.3333333333333333
Caught off Guard,Overpass,1,2,3,0.3333333333333333
Caught off Guard,Vertigo,1,2,3,0.3333333333333333
CearГЎ,Ancient,2,2,4,0.5
CearГЎ,Dust2,1,0,1,1.0
CearГЎ,Inferno,1,2,3,0.3333333333333333
CearГЎ,Mirage,2,2,4,0.5
CearГЎ,Nuke,3,4,7,0.42857142857142855
CearГЎ,Overpass,0,1,1,0.0
Checkmate,Ancient,1,2,3,0.3333333333333333
Checkmate,Dust2,11,8,19,0.5789473684210527
Checkmate,Inferno,15,4,19,0.7894736842105263
Checkmate,Mirage,5,3,8,0.625
Checkmate,Nuke,9,5,14,0.6428571428571429
Checkmate,Overpass,3,3,6,0.5
Checkmate,Vertigo,3,1,4,0.75
Chetz,Ancient,0,1,1,0.0
Chetz,Overpass,0,1,1,0.0
Chetz,Vertigo,1,0,1,1.0
Chiefs,Ancient,1,1,2,0.5
Chiefs,Dust2,3,1,4,0.75
Chiefs,Inferno,2,0,2,1.0
Chiefs,Mirage,4,0,4,1.0
Chiefs,Nuke,4,2,6,0.6666666666666666
Chile,Dust2,1,0,1,1.0
Chile,Inferno,0,1,1,0.0
Chile,Mirage,0,1,1,0.0
ChocoCheck,Ancient,6,4,10,0.6
ChocoCheck,Dust2,5,7,12,0.4166666666666667
ChocoCheck,Inferno,15,9,24,0.625
ChocoCheck,Mirage,22,9,31,0.7096774193548387
ChocoCheck,Nuke,3,2,5,0.6
ChocoCheck,Overpass,2,9,11,0.18181818181818182
ChocoCheck,Vertigo,5,2,7,0.7142857142857143
Clique,Nuke,0,1,1,0.0
Clique,Overpass,0,1,1,0.0
Cloud,Ancient,0,1,1,0.0
Cloud,Mirage,0,1,1,0.0
Cloud9,Ancient,8,3,11,0.7272727272727273
Cloud9,Anubis,1,0,1,1.0
Cloud9,Dust2,7,5,12,0.5833333333333334
Cloud9,Inferno,9,10,19,0.47368421052631576
Cloud9,Mirage,12,6,18,0.6666666666666666
Cloud9,Nuke,0,1,1,0.0
Cloud9,Overpass,11,5,16,0.6875
Cloud9,Vertigo,9,6,15,0.6
CloudRunners,Ancient,0,1,1,0.0
CloudRunners,Dust2,1,1,2,0.5
CloudRunners,Inferno,3,2,5,0.6
CloudRunners,Mirage,0,2,2,0.0
CloudRunners,Nuke,1,0,1,1.0
CloudRunners,Vertigo,1,0,1,1.0
Clown5,Dust2,0,1,1,0.0
Clown5,Inferno,1,0,1,1.0
Clown5,Mirage,1,1,2,0.5
Clown5,Overpass,1,0,1,1.0
Clutch,Ancient,1,2,3,0.3333333333333333
Clutch,Anubis,0,4,4,0.0
Clutch,Inferno,2,5,7,0.2857142857142857
Clutch,Mirage,1,1,2,0.5
Clutch,Nuke,5,6,11,0.45454545454545453
Clutch,Overpass,2,0,2,1.0
Clutch,Vertigo,0,1,1,0.0
Coalesce,Ancient,4,4,8,0.5
Coalesce,Anubis,2,2,4,0.5
Coalesce,Dust2,1,3,4,0.25
Coalesce,Inferno,10,6,16,0.625
Coalesce,Mirage,2,7,9,0.2222222222222222
Coalesce,Nuke,5,6,11,0.45454545454545453
Coalesce,Overpass,8,6,14,0.5714285714285714
Coalesce,Vertigo,14,10,24,0.5833333333333334
Coastal Mayhem,Ancient,0,1,1,0.0
Coastal Mayhem,Inferno,0,1,1,0.0
Coastal Mayhem,Mirage,1,1,2,0.5
Coastal Mayhem,Overpass,1,0,1,1.0
Cocolovers,Ancient,0,1,1,0.0
Cocolovers,Inferno,0,1,1,0.0
Cocolovers,Mirage,2,0,2,1.0
Cocolovers,Nuke,1,0,1,1.0
Coldest Riders,Ancient,3,5,8,0.375
Coldest Riders,Dust2,1,3,4,0.25
Coldest Riders,Inferno,0,2,2,0.0
Coldest Riders,Mirage,9,4,13,0.6923076923076923
Coldest Riders,Nuke,6,9,15,0.4
Coldest Riders,Overpass,3,5,8,0.375
Coldest Riders,Vertigo,3,3,6,0.5
Collateral,Ancient,1,4,5,0.2
Collateral,Inferno,0,3,3,0.0
Collateral,Mirage,0,3,3,0.0
Collateral,Nuke,1,2,3,0.3333333333333333
Collateral,Overpass,0,1,1,0.0
Complexity,Ancient,12,20,32,0.375
Complexity,Anubis,2,7,9,0.2222222222222222
Complexity,Dust2,7,11,18,0.3888888888888889
Complexity,Inferno,15,24,39,0.38461538461538464
Complexity,Mirage,8,10,18,0.4444444444444444
Complexity,Nuke,24,20,44,0.5454545454545454
Complexity,Overpass,30,20,50,0.6
Complexity,Vertigo,10,14,24,0.4166666666666667
Conquer,Ancient,5,5,10,0.5
Conquer,Dust2,2,1,3,0.6666666666666666
Conquer,Inferno,9,9,18,0.5
Conquer,Mirage,3,6,9,0.3333333333333333
Conquer,Nuke,7,4,11,0.6363636363636364
Conquer,Overpass,2,1,3,0.6666666666666666
Conquer,Vertigo,4,4,8,0.5
Cookie Clowns,Ancient,1,0,1,1.0
Cookie Clowns,Inferno,1,1,2,0.5
Cookie Clowns,Nuke,0,1,1,0.0
Copenhagen Flames,Ancient,58,26,84,0.6904761904761905
Copenhagen Flames,Anubis,1,1,2,0.5
Copenhagen Flames,Dust2,11,11,22,0.5
Copenhagen Flames,Inferno,30,31,61,0.4918032786885246
Copenhagen Flames,Mirage,24,19,43,0.5581395348837209
Copenhagen Flames,Nuke,44,31,75,0.5866666666666667
Copenhagen Flames,Overpass,45,20,65,0.6923076923076923
Copenhagen Flames,Vertigo,48,26,74,0.6486486486486487
Corinthians,Ancient,2,1,3,0.6666666666666666
Corinthians,Anubis,4,2,6,0.6666666666666666
Corinthians,Dust2,4,4,8,0.5
Corinthians,Inferno,8,7,15,0.5333333333333333
Corinthians,Mirage,5,6,11,0.45454545454545453
Corinthians,Nuke,6,9,15,0.4
Corinthians,Overpass,4,5,9,0.4444444444444444
Corinthians,Vertigo,2,1,3,0.6666666666666666
Corinthians Academy,Ancient,1,4,5,0.2
Corinthians Academy,Dust2,0,2,2,0.0
Corinthians Academy,Inferno,0,1,1,0.0
Corinthians Academy,Mirage,1,0,1,1.0
Corinthians Academy,Nuke,0,4,4,0.0
Corinthians Academy,Overpass,2,1,3,0.6666666666666666
Corinthians Academy,Vertigo,2,1,3,0.6666666666666666
Coscu Army,Ancient,2,3,5,0.4
Coscu Army,Dust2,8,4,12,0.6666666666666666
Coscu Army,Inferno,2,1,3,0.6666666666666666
Coscu Army,Mirage,4,3,7,0.5714285714285714
Coscu Army,Nuke,3,11,14,0.21428571428571427
Coscu Army,Overpass,4,5,9,0.4444444444444444
Coscu Army,Vertigo,0,1,1,0.0
Cosmoss Riga,Ancient,0,1,1,0.0
Cosmoss Riga,Overpass,0,1,1,0.0
Cossacks,Inferno,1,1,2,0.5
Cossacks,Mirage,1,0,1,1.0
Cossacks,Nuke,0,1,1,0.0
Counter Nature,Dust2,1,1,2,0.5
Counter Nature,Inferno,2,0,2,1.0
Counter Nature,Mirage,0,1,1,0.0
Counter Nature,Nuke,1,1,2,0.5
Counter Nature,Overpass,0,2,2,0.0
Croatia,Dust2,0,1,1,0.0
Croatia,Inferno,1,1,2,0.5
Croatia,Mirage,2,2,4,0.5
Croatia,Overpass,1,0,1,1.0
Croatia,Vertigo,1,2,3,0.3333333333333333
Cruzeiro,Ancient,2,4,6,0.3333333333333333
Cruzeiro,Dust2,7,5,12,0.5833333333333334
Cruzeiro,Inferno,5,5,10,0.5
Cruzeiro,Mirage,3,4,7,0.42857142857142855
Cruzeiro,Overpass,1,4,5,0.2
Cruzeiro,Vertigo,3,2,5,0.6
Cruzeiro fe,Ancient,0,1,1,0.0
Cruzeiro fe,Vertigo,0,1,1,0.0
Cryptova,Ancient,1,3,4,0.25
Cryptova,Dust2,0,4,4,0.0
Cryptova,Inferno,6,11,17,0.35294117647058826
Cryptova,Mirage,9,4,13,0.6923076923076923
Cryptova,Nuke,1,4,5,0.2
Cryptova,Overpass,1,8,9,0.1111111111111111
Cryptova,Vertigo,2,0,2,1.0
Cyberstorm,Ancient,1,0,1,1.0
Cyberstorm,Inferno,0,2,2,0.0
Cyberstorm,Nuke,0,2,2,0.0
Cyberstorm,Overpass,1,1,2,0.5
Cyberstorm,Vertigo,0,1,1,0.0
Czech Republic,Dust2,1,0,1,1.0
Czech Republic,Inferno,1,1,2,0.5
Czech Republic,Mirage,1,1,2,0.5
Czech Republic,Vertigo,0,1,1,0.0
D13,Ancient,4,7,11,0.36363636363636365
D13,Dust2,2,4,6,0.3333333333333333
D13,Inferno,5,10,15,0.3333333333333333
D13,Mirage,2,4,6,0.3333333333333333
D13,Nuke,8,12,20,0.4
D13,Vertigo,2,3,5,0.4
DBL PONEY,Ancient,10,12,22,0.45454545454545453
DBL PONEY,Dust2,12,9,21,0.5714285714285714
DBL PONEY,Inferno,19,14,33,0.5757575757575758
DBL PONEY,Nuke,15,14,29,0.5172413793103449
DBL PONEY,Overpass,11,8,19,0.5789473684210527
DBL PONEY,Vertigo,29,8,37,0.7837837837837838
DEADiNSIDE,Nuke,0,1,1,0.0
DETONA,Ancient,1,2,3,0.3333333333333333
DETONA,Dust2,8,9,17,0.47058823529411764
DETONA,Inferno,3,5,8,0.375
DETONA,Mirage,0,1,1,0.0
DETONA,Nuke,2,10,12,0.16666666666666666
DETONA,Overpass,5,6,11,0.45454545454545453
DETONA,Vertigo,0,3,3,0.0
DGG,Ancient,5,1,6,0.8333333333333334
DGG,Dust2,3,3,6,0.5
DGG,Inferno,13,7,20,0.65
DGG,Mirage,10,9,19,0.5263157894736842
DGG,Nuke,5,5,10,0.5
DGG,Overpass,1,1,2,0.5
DGG,Vertigo,8,10,18,0.4444444444444444
DHLG,Mirage,0,1,1,0.0
DHLG,Nuke,0,1,1,0.0
DISKODISKO,Ancient,0,1,1,0.0
DISKODISKO,Overpass,0,1,1,0.0
DNA,Ancient,0,3,3,0.0
DNA,Dust2,0,1,1,0.0
DNA,Inferno,0,7,7,0.0
DNA,Mirage,0,3,3,0.0
DNA,Nuke,0,2,2,0.0
DNA,Vertigo,1,4,5,0.2
DNG,Ancient,1,0,1,1.0
DNG,Dust2,1,0,1,1.0
DNG,Inferno,1,0,1,1.0
DNG,Mirage,2,1,3,0.6666666666666666
DNG,Nuke,1,1,2,0.5
DNG,Overpass,1,2,3,0.3333333333333333
DNG,Vertigo,0,1,1,0.0
DNMK,Ancient,0,1,1,0.0
DNMK,Dust2,1,4,5,0.2
DNMK,Inferno,3,6,9,0.3333333333333333
DNMK,Mirage,1,5,6,0.16666666666666666
DNMK,Nuke,2,2,4,0.5
DNMK,Overpass,1,0,1,1.0
DNMK,Vertigo,0,1,1,0.0
DOGS,Ancient,1,0,1,1.0
DOGS,Inferno,1,0,1,1.0
DOGS,Mirage,1,0,1,1.0
DOGS,Nuke,0,1,1,0.0
DOGS,Overpass,1,1,2,0.5
DOGS,Vertigo,0,1,1,0.0
DREAM,Ancient,0,1,1,0.0
DREAM,Dust2,1,1,2,0.5
DREAM,Inferno,6,1,7,0.8571428571428571
DREAM,Mirage,3,7,10,0.3
DREAM,Nuke,6,4,10,0.6
DREAM,Overpass,4,5,9,0.4444444444444444
DREAM,Vertigo,2,5,7,0.2857142857142857
DREAM UA,Ancient,1,0,1,1.0
DREAM UA,Inferno,0,1,1,0.0
DREAM UA,Mirage,1,0,1,1.0
DREAM UA,Nuke,0,1,1,0.0
DREAM UA,Vertigo,0,2,2,0.0
DU Black,Ancient,0,1,1,0.0
DU Black,Dust2,0,1,1,0.0
DU Black,Overpass,1,0,1,1.0
DUELISTS,Dust2,0,1,1,0.0
DUELISTS,Nuke,1,0,1,1.0
DUELISTS,Vertigo,0,1,1,0.0
DUSTY,Ancient,1,0,1,1.0
DUSTY,Dust2,1,2,3,0.3333333333333333
DUSTY,Inferno,3,4,7,0.42857142857142855
DUSTY,Mirage,1,2,3,0.3333333333333333
DUSTY,Nuke,2,1,3,0.6666666666666666
DUSTY,Overpass,2,4,6,0.3333333333333333
DUSTY,Vertigo,2,0,2,1.0
Daddypeek,Inferno,0,1,1,0.0
Daddypeek,Mirage,0,1,1,0.0
Daotsu,Ancient,5,8,13,0.38461538461538464
Daotsu,Dust2,21,7,28,0.75
Daotsu,Inferno,7,8,15,0.4666666666666667
Daotsu,Mirage,13,7,20,0.65
Daotsu,Nuke,8,9,17,0.47058823529411764
Daotsu,Overpass,4,4,8,0.5
Daotsu,Vertigo,0,1,1,0.0
Dark Tigers,Dust2,0,2,2,0.0
Dark Tigers,Inferno,0,1,1,0.0
Dark Tigers,Mirage,0,2,2,0.0
Dark Tigers,Nuke,0,1,1,0.0
Datakrigerne,Ancient,0,1,1,0.0
Datakrigerne,Inferno,1,0,1,1.0
Datakrigerne,Overpass,1,1,2,0.5
Datakrigerne,Vertigo,1,0,1,1.0
Daugava,Dust2,0,1,1,0.0
Daugava,Inferno,1,0,1,1.0
Daugava,Mirage,2,1,3,0.6666666666666666
Daugava,Nuke,2,1,3,0.6666666666666666
Daugava,Overpass,2,0,2,1.0
Daugava,Vertigo,2,1,3,0.6666666666666666
Davenport University,Ancient,0,5,5,0.0
Davenport University,Anubis,1,1,2,0.5
Davenport University,Dust2,6,4,10,0.6
Davenport University,Inferno,12,18,30,0.4
Davenport University,Mirage,1,2,3,0.3333333333333333
Davenport University,Nuke,12,9,21,0.5714285714285714
Davenport University,Overpass,10,18,28,0.35714285714285715
Davenport University,Vertigo,6,10,16,0.375
DeadWeight,Ancient,1,0,1,1.0
DeadWeight,Anubis,0,1,1,0.0
DeadWeight,Dust2,1,1,2,0.5
DeadWeight,Inferno,3,3,6,0.5
DeadWeight,Mirage,1,2,3,0.3333333333333333
DeadWeight,Vertigo,1,2,3,0.3333333333333333
Demon Time,Nuke,0,1,1,0.0
Detonate,Ancient,6,5,11,0.5454545454545454
Detonate,Anubis,2,2,4,0.5
Detonate,Dust2,6,5,11,0.5454545454545454
Detonate,Inferno,24,22,46,0.5217391304347826
Detonate,Mirage,13,15,28,0.4642857142857143
Detonate,Nuke,13,17,30,0.43333333333333335
Detonate,Overpass,10,17,27,0.37037037037037035
Detonate,Vertigo,10,13,23,0.43478260869565216
Devercy,Dust2,0,1,1,0.0
Die hard,Inferno,1,0,1,1.0
Die hard,Mirage,0,1,1,0.0
Die hard,Overpass,1,0,1,1.0
Diffendo,Overpass,0,1,1,0.0
Dignitas,Ancient,6,12,18,0.3333333333333333
Dignitas,Dust2,1,2,3,0.3333333333333333
Dignitas,Inferno,17,10,27,0.6296296296296297
Dignitas,Mirage,18,18,36,0.5
Dignitas,Nuke,24,17,41,0.5853658536585366
Dignitas,Overpass,12,14,26,0.46153846153846156
Dignitas,Vertigo,15,10,25,0.6
Dire Wolves,Ancient,2,0,2,1.0
Dire Wolves,Dust2,3,0,3,1.0
Dire Wolves,Inferno,4,0,4,1.0
Dire Wolves,Mirage,0,1,1,0.0
Dire Wolves,Nuke,1,0,1,1.0
Dire Wolves,Overpass,1,1,2,0.5
Dire Wolves,Vertigo,2,0,2,1.0
Disconnected,Ancient,3,1,4,0.75
Disconnected,Dust2,0,2,2,0.0
Disconnected,Inferno,2,7,9,0.2222222222222222
Disconnected,Mirage,3,10,13,0.23076923076923078
Disconnected,Nuke,4,4,8,0.5
Disconnected,Overpass,1,1,2,0.5
Disconnected,Vertigo,1,4,5,0.2
Divine Vendetta,Ancient,1,1,2,0.5
Divine Vendetta,Inferno,0,1,1,0.0
Divine Vendetta,Overpass,0,2,2,0.0
Divine Vendetta,Vertigo,2,1,3,0.6666666666666666
Dobegaem,Ancient,0,1,1,0.0
Dobegaem,Vertigo,0,1,1,0.0
Doge Soldiers,Dust2,0,1,1,0.0
Doge Soldiers,Inferno,1,1,2,0.5
Doge Soldiers,Mirage,1,1,2,0.5
Doge Soldiers,Nuke,2,0,2,1.0
Doge Soldiers,Vertigo,0,1,1,0.0
Doing Fun,Inferno,1,1,2,0.5
Doing Fun,Mirage,0,1,1,0.0
Doing Fun,Overpass,3,0,3,1.0
Doing Fun,Vertigo,2,1,3,0.6666666666666666
Dolej Miodu,Ancient,2,0,2,1.0
Dolej Miodu,Inferno,0,1,1,0.0
Dolej Miodu,Mirage,0,1,1,0.0
Dolej Miodu,Nuke,1,3,4,0.25
Dolej Miodu,Overpass,1,0,1,1.0
Dolej Miodu,Vertigo,3,0,3,1.0
DotMax,Inferno,0,1,1,0.0
DotMax,Vertigo,0,1,1,0.0
Dr. Pepper,Inferno,0,1,1,0.0
Dr. Pepper,Mirage,0,1,1,0.0
Dripmen,Anubis,2,2,4,0.5
Dripmen,Dust2,0,1,1,0.0
Dripmen,Inferno,1,2,3,0.3333333333333333
Dripmen,Mirage,1,1,2,0.5
Dripmen,Nuke,2,1,3,0.6666666666666666
Dripmen,Overpass,2,0,2,1.0
Dripmen,Vertigo,1,5,6,0.16666666666666666
Drypeek,Ancient,0,1,1,0.0
Drypeek,Dust2,2,0,2,1.0
Drypeek,Inferno,4,1,5,0.8
Drypeek,Mirage,0,1,1,0.0
Drypeek,Nuke,1,0,1,1.0
Drypeek,Overpass,1,0,1,1.0
Drypeek,Vertigo,2,2,4,0.5
Durany,Dust2,0,1,1,0.0
Durany,Inferno,1,0,1,1.0
Durany,Mirage,1,1,2,0.5
Durany,Nuke,0,2,2,0.0
Dynasty,Ancient,3,4,7,0.42857142857142855
Dynasty,Dust2,3,6,9,0.3333333333333333
Dynasty,Inferno,4,8,12,0.3333333333333333
Dynasty,Mirage,3,5,8,0.375
Dynasty,Nuke,4,5,9,0.4444444444444444
Dynasty,Overpass,2,4,6,0.3333333333333333
Dynasty,Vertigo,6,7,13,0.46153846153846156
EC Brugge,Ancient,15,22,37,0.40540540540540543
EC Brugge,Anubis,4,4,8,0.5
EC Brugge,Dust2,10,12,22,0.45454545454545453
EC Brugge,Inferno,10,27,37,0.2702702702702703
EC Brugge,Mirage,27,39,66,0.4090909090909091
EC Brugge,Nuke,30,24,54,0.5555555555555556
EC Brugge,Overpass,0,3,3,0.0
EC Brugge,Vertigo,20,33,53,0.37735849056603776
EC Kyiv,Ancient,12,14,26,0.46153846153846156
EC Kyiv,Dust2,26,27,53,0.49056603773584906
EC Kyiv,Inferno,41,25,66,0.6212121212121212
EC Kyiv,Mirage,21,27,48,0.4375
EC Kyiv,Overpass,16,23,39,0.41025641025641024
EC Kyiv,Vertigo,22,21,43,0.5116279069767442
EC Sivas,Ancient,0,2,2,0.0
EC Sivas,Dust2,0,1,1,0.0
EC Sivas,Mirage,0,1,1,0.0
EC Sivas,Vertigo,0,1,1,0.0
ECLOT,Ancient,26,30,56,0.4642857142857143
ECLOT,Dust2,19,16,35,0.5428571428571428
ECLOT,Inferno,47,41,88,0.5340909090909091
ECLOT,Mirage,54,38,92,0.5869565217391305
ECLOT,Nuke,1,4,5,0.2
ECLOT,Overpass,20,29,49,0.40816326530612246
ECLOT,Vertigo,26,22,48,0.5416666666666666
ECSTATIC,Ancient,29,26,55,0.5272727272727272
ECSTATIC,Anubis,7,1,8,0.875
ECSTATIC,Dust2,19,21,40,0.475
ECSTATIC,Inferno,26,26,52,0.5
ECSTATIC,Mirage,6,16,22,0.2727272727272727
ECSTATIC,Nuke,25,29,54,0.46296296296296297
ECSTATIC,Overpass,22,27,49,0.4489795918367347
ECSTATIC,Vertigo,37,36,73,0.5068493150684932
EG Black,Ancient,1,0,1,1.0
EG Black,Dust2,2,5,7,0.2857142857142857
EG Black,Inferno,18,6,24,0.75
EG Black,Mirage,10,8,18,0.5555555555555556
EG Black,Nuke,6,6,12,0.5
EG Black,Overpass,17,7,24,0.7083333333333334
EG Black,Vertigo,7,3,10,0.7
EG Gold,Ancient,1,0,1,1.0
EG Gold,Dust2,1,1,2,0.5
EG Gold,Inferno,1,1,2,0.5
EG Gold,Mirage,0,2,2,0.0
EG Gold,Overpass,0,3,3,0.0
EG White,Anubis,1,0,1,1.0
EG White,Dust2,3,3,6,0.5
EG White,Inferno,6,7,13,0.46153846153846156
EG White,Mirage,8,1,9,0.8888888888888888
EG White,Nuke,10,3,13,0.7692307692307693
EG White,Overpass,9,5,14,0.6428571428571429
EG White,Vertigo,6,2,8,0.75
EKO,Ancient,0,3,3,0.0
EKO,Inferno,5,5,10,0.5
EKO,Mirage,4,0,4,1.0
EKO,Nuke,3,2,5,0.6
EKO,Overpass,4,3,7,0.5714285714285714
EKO,Vertigo,5,3,8,0.625
ELES,Ancient,0,1,1,0.0
ELES,Dust2,1,2,3,0.3333333333333333
ELES,Inferno,1,2,3,0.3333333333333333
ELES,Mirage,0,2,2,0.0
ELEVATE,Dust2,0,1,1,0.0
ELEVATE,Inferno,1,2,3,0.3333333333333333
ELEVATE,Mirage,0,1,1,0.0
ELEVATE,Nuke,1,1,2,0.5
ELEVATE,Vertigo,1,0,1,1.0
ENCE,Ancient,26,19,45,0.5777777777777777
ENCE,Anubis,1,4,5,0.2
ENCE,Dust2,15,12,27,0.5555555555555556
ENCE,Inferno,5,4,9,0.5555555555555556
ENCE,Mirage,36,24,60,0.6
ENCE,Nuke,50,24,74,0.6756756756756757
ENCE,Overpass,16,23,39,0.41025641025641024
ENCE,Vertigo,20,19,39,0.5128205128205128
ENCE Academy,Ancient,6,5,11,0.5454545454545454
ENCE Academy,Dust2,0,1,1,0.0
ENCE Academy,Inferno,2,1,3,0.6666666666666666
ENCE Academy,Mirage,11,15,26,0.4230769230769231
ENCE Academy,Nuke,5,7,12,0.4166666666666667
ENCE Academy,Overpass,5,8,13,0.38461538461538464
ENCE Academy,Vertigo,2,5,7,0.2857142857142857
ENDGAME,Inferno,1,0,1,1.0
ENDGAME,Mirage,1,0,1,1.0
ENDGAME,Vertigo,1,0,1,1.0
EPG Family,Ancient,0,3,3,0.0
EPG Family,Dust2,0,1,1,0.0
EPG Family,Mirage,2,0,2,1.0
EPG Family,Nuke,0,2,2,0.0
EPG Family,Overpass,0,2,2,0.0
EPG Family,Vertigo,2,0,2,1.0
EPIC DUDES,Ancient,1,0,1,1.0
EPIC DUDES,Dust2,1,0,1,1.0
EPIC DUDES,Inferno,2,0,2,1.0
EPIC DUDES,Mirage,1,1,2,0.5
EPIC DUDES,Nuke,0,3,3,0.0
EPIC DUDES,Overpass,2,3,5,0.4
EPIC DUDES,Vertigo,0,2,2,0.0
ESC,Inferno,0,1,1,0.0
ESC,Nuke,0,1,1,0.0
ESCA,Ancient,0,1,1,0.0
ESCA,Dust2,0,1,1,0.0
ESCA,Inferno,2,4,6,0.3333333333333333
ESCA,Mirage,0,1,1,0.0
ESCA,Nuke,1,2,3,0.3333333333333333
ESCA,Overpass,1,2,3,0.3333333333333333
ESCA,Vertigo,2,0,2,1.0
ESK,Ancient,0,2,2,0.0
ESK,Dust2,0,1,1,0.0
ESK,Inferno,2,1,3,0.6666666666666666
ESK,Mirage,1,2,3,0.3333333333333333
ESTOWNIA,Ancient,5,4,9,0.5555555555555556
ESTOWNIA,Dust2,2,4,6,0.3333333333333333
ESTOWNIA,Inferno,4,0,4,1.0
ESTOWNIA,Mirage,3,3,6,0.5
ESTOWNIA,Overpass,1,4,5,0.2
ESTOWNIA,Vertigo,2,0,2,1.0
EU JOGO BOLA,Nuke,0,1,1,0.0
EUMIX,Dust2,1,1,2,0.5
EUMIX,Mirage,1,1,2,0.5
EUMIX,Nuke,0,2,2,0.0
EVILNINE,Dust2,0,1,1,0.0
EVILNINE,Inferno,1,1,2,0.5
EVILNINE,Nuke,0,1,1,0.0
EX CINERE,Inferno,1,1,2,0.5
EX CINERE,Nuke,3,1,4,0.75
EX CINERE,Overpass,0,2,2,0.0
EX CINERE,Vertigo,0,2,2,0.0
EXEN,Ancient,1,6,7,0.14285714285714285
EXEN,Inferno,4,3,7,0.5714285714285714
EXEN,Nuke,0,4,4,0.0
EXEN,Overpass,0,4,4,0.0
EXLI-KUBAB,Ancient,1,1,2,0.5
EXLI-KUBAB,Nuke,0,2,2,0.0
EXLI-KUBAB,Overpass,0,1,1,0.0
EXTREMUM,Dust2,1,0,1,1.0
EXTREMUM,Inferno,2,1,3,0.6666666666666666
EXTREMUM,Mirage,2,2,4,0.5
EXTREMUM,Nuke,3,2,5,0.6
EXTREMUM,Vertigo,0,2,2,0.0
EYEBALLERS,Ancient,16,15,31,0.5161290322580645
EYEBALLERS,Anubis,4,4,8,0.5
EYEBALLERS,Dust2,6,4,10,0.6
EYEBALLERS,Inferno,26,16,42,0.6190476190476191
EYEBALLERS,Mirage,14,26,40,0.35
EYEBALLERS,Overpass,18,12,30,0.6
EYEBALLERS,Vertigo,13,14,27,0.48148148148148145
Ea Dupla,Inferno,0,1,1,0.0
EagleEye,Dust2,0,1,1,0.0
Earlybirds,Inferno,0,1,1,0.0
Earlybirds,Nuke,1,0,1,1.0
Earlybirds,Overpass,1,1,2,0.5
Earlybirds,Vertigo,0,1,1,0.0
Eclipse,Ancient,2,1,3,0.6666666666666666
Eclipse,Inferno,0,1,1,0.0
Eclipse,Mirage,1,2,3,0.3333333333333333
Eclipse,Overpass,1,3,4,0.25
Eclipse Reborn,Overpass,0,1,1,0.0
Ecuador,Dust2,0,1,1,0.0
Ecuador,Inferno,0,1,1,0.0
Edward's Team,Dust2,1,1,2,0.5
Edward's Team,Inferno,3,0,3,1.0
Edward's Team,Mirage,2,2,4,0.5
Edward's Team,Nuke,1,1,2,0.5
Edward's Team,Overpass,1,0,1,1.0
Edward's Team,Vertigo,3,0,3,1.0
Ego,Inferno,0,1,1,0.0
Ego,Mirage,1,0,1,1.0
Ego,Nuke,0,1,1,0.0
Electrify Steel,Ancient,0,1,1,0.0
Electrify Steel,Dust2,2,1,3,0.6666666666666666
Electrify Steel,Inferno,4,3,7,0.5714285714285714
Electrify Steel,Mirage,7,4,11,0.6363636363636364
Electrify Steel,Nuke,1,2,3,0.3333333333333333
Electrify Steel,Overpass,0,1,1,0.0
Electrify Steel,Vertigo,1,5,6,0.16666666666666666
Elemental,Ancient,0,1,1,0.0
Elemental,Dust2,1,2,3,0.3333333333333333
Elemental,Inferno,0,4,4,0.0
Elemental,Mirage,0,2,2,0.0
Elemental,Vertigo,1,1,2,0.5
Elite,Dust2,0,1,1,0.0
Elite,Nuke,0,1,1,0.0
Emps Kids,Ancient,1,0,1,1.0
Emps Kids,Dust2,1,1,2,0.5
Emps Kids,Inferno,0,1,1,0.0
Emps Kids,Vertigo,1,0,1,1.0
En av de lette,Ancient,0,2,2,0.0
En av de lette,Mirage,0,1,1,0.0
En av de lette,Overpass,0,2,2,0.0
Encore,Ancient,2,3,5,0.4
Encore,Dust2,2,4,6,0.3333333333333333
Encore,Inferno,5,6,11,0.45454545454545453
Encore,Mirage,2,3,5,0.4
Encore,Nuke,7,10,17,0.4117647058823529
Encore,Overpass,3,1,4,0.75
Encore,Vertigo,9,7,16,0.5625
Endangered,Ancient,0,2,2,0.0
Endangered,Inferno,0,3,3,0.0
Endangered,Mirage,1,0,1,1.0
Endangered,Nuke,0,1,1,0.0
Endpoint,Ancient,34,29,63,0.5396825396825397
Endpoint,Anubis,2,3,5,0.4
Endpoint,Dust2,19,16,35,0.5428571428571428
Endpoint,Inferno,29,30,59,0.4915254237288136
Endpoint,Mirage,30,32,62,0.4838709677419355
Endpoint,Nuke,5,9,14,0.35714285714285715
Endpoint,Overpass,22,17,39,0.5641025641025641
Endpoint,Vertigo,33,29,62,0.532258064516129
Enhanced,Ancient,1,4,5,0.2
Enhanced,Dust2,0,2,2,0.0
Enhanced,Inferno,0,3,3,0.0
Enhanced,Mirage,1,0,1,1.0
Enhanced,Nuke,1,1,2,0.5
Enhanced,Overpass,1,1,2,0.5
Enhanced,Vertigo,0,1,1,0.0
Ennemi,Ancient,0,1,1,0.0
Ennemi,Dust2,0,1,1,0.0
Enough,Inferno,0,1,1,0.0
Enough,Mirage,0,1,1,0.0
Enough,Nuke,0,1,1,0.0
Enterprise,Ancient,22,30,52,0.4230769230769231
Enterprise,Dust2,13,20,33,0.3939393939393939
Enterprise,Inferno,53,41,94,0.5638297872340425
Enterprise,Mirage,40,32,72,0.5555555555555556
Enterprise,Nuke,17,28,45,0.37777777777777777
Enterprise,Overpass,33,33,66,0.5
Enterprise,Vertigo,6,15,21,0.2857142857142857
Entropiq,Ancient,43,28,71,0.6056338028169014
Entropiq,Dust2,31,27,58,0.5344827586206896
Entropiq,Inferno,2,3,5,0.4
Entropiq,Mirage,38,23,61,0.6229508196721312
Entropiq,Nuke,27,24,51,0.5294117647058824
Entropiq,Overpass,40,27,67,0.5970149253731343
Entropiq,Vertigo,23,31,54,0.42592592592592593
Entropiq Prague,Ancient,2,0,2,1.0
Entropiq Prague,Dust2,10,7,17,0.5882352941176471
Entropiq Prague,Inferno,9,19,28,0.32142857142857145
Entropiq Prague,Mirage,12,17,29,0.41379310344827586
Entropiq Prague,Nuke,9,19,28,0.32142857142857145
Entropiq Prague,Overpass,10,7,17,0.5882352941176471
Entropiq Prague,Vertigo,9,9,18,0.5
Entropy,Ancient,1,3,4,0.25
Entropy,Dust2,1,3,4,0.25
Entropy,Inferno,0,3,3,0.0
Entropy,Mirage,4,2,6,0.6666666666666666
Entropy,Nuke,1,3,4,0.25
Entropy,Overpass,4,2,6,0.6666666666666666
Eqole,Dust2,0,1,1,0.0
Eqole,Inferno,0,4,4,0.0
Eqole,Nuke,1,0,1,1.0
Eqole,Overpass,1,0,1,1.0
Eros,Ancient,6,6,12,0.5
Eros,Anubis,0,1,1,0.0
Eros,Dust2,1,7,8,0.125
Eros,Inferno,13,22,35,0.37142857142857144
Eros,Mirage,11,19,30,0.36666666666666664
Eros,Nuke,11,15,26,0.4230769230769231
Eros,Overpass,0,7,7,0.0
Eros,Vertigo,11,11,22,0.5
Eros Black,Mirage,1,1,2,0.5
Eros Black,Nuke,0,1,1,0.0
Eros Black,Vertigo,0,1,1,0.0
Eruption,Ancient,6,2,8,0.75
Eruption,Anubis,5,2,7,0.7142857142857143
Eruption,Inferno,4,5,9,0.4444444444444444
Eruption,Mirage,1,1,2,0.5
Eruption,Nuke,0,3,3,0.0
Eruption,Overpass,2,1,3,0.6666666666666666
Eruption,Vertigo,0,2,2,0.0
Esoteric,Ancient,1,0,1,1.0
Esoteric,Dust2,1,1,2,0.5
Esoteric,Inferno,0,2,2,0.0
Esoteric,Nuke,0,1,1,0.0
Esoteric,Overpass,0,1,1,0.0
Eternal Fire,Ancient,1,1,2,0.5
Eternal Fire,Anubis,10,5,15,0.6666666666666666
Eternal Fire,Dust2,39,20,59,0.6610169491525424
Eternal Fire,Inferno,51,31,82,0.6219512195121951
Eternal Fire,Mirage,24,27,51,0.47058823529411764
Eternal Fire,Nuke,45,30,75,0.6
Eternal Fire,Overpass,31,24,55,0.5636363636363636
Eternal Fire,Vertigo,50,31,81,0.6172839506172839
Eternal Fire Academy,Ancient,0,3,3,0.0
Eternal Fire Academy,Dust2,2,6,8,0.25
Eternal Fire Academy,Inferno,4,12,16,0.25
Eternal Fire Academy,Mirage,7,9,16,0.4375
Eternal Fire Academy,Nuke,1,5,6,0.16666666666666666
Eternal Fire Academy,Overpass,2,3,5,0.4
Eternal Fire Academy,Vertigo,1,8,9,0.1111111111111111
Europe,Dust2,0,1,1,0.0
Europe,Inferno,1,0,1,1.0
Europe,Mirage,1,0,1,1.0
EveryBody Dance,Overpass,0,1,1,0.0
Evil Geniuses,Ancient,2,3,5,0.4
Evil Geniuses,Anubis,0,5,5,0.0
Evil Geniuses,Dust2,1,14,15,0.06666666666666667
Evil Geniuses,Inferno,17,22,39,0.4358974358974359
Evil Geniuses,Mirage,8,13,21,0.38095238095238093
Evil Geniuses,Nuke,10,18,28,0.35714285714285715
Evil Geniuses,Overpass,13,14,27,0.48148148148148145
Evil Geniuses,Vertigo,0,10,10,0.0
Exalted Industries,Ancient,0,1,1,0.0
Exalted Industries,Mirage,1,0,1,1.0
Exalty,Ancient,0,2,2,0.0
Exalty,Dust2,1,1,2,0.5
Exalty,Inferno,2,4,6,0.3333333333333333
Exalty,Mirage,0,1,1,0.0
Exalty,Nuke,1,2,3,0.3333333333333333
Exsto,Dust2,0,1,1,0.0
Exsto,Inferno,2,1,3,0.6666666666666666
Exsto,Mirage,0,1,1,0.0
Exsto,Vertigo,1,1,2,0.5
Extra Salt,Ancient,17,9,26,0.6538461538461539
Extra Salt,Dust2,4,1,5,0.8
Extra Salt,Inferno,25,9,34,0.7352941176470589
Extra Salt,Mirage,1,2,3,0.3333333333333333
Extra Salt,Nuke,25,9,34,0.7352941176470589
Extra Salt,Overpass,25,5,30,0.8333333333333334
Extra Salt,Vertigo,19,7,26,0.7307692307692307
FAMBIT,Ancient,2,3,5,0.4
FAMBIT,Inferno,3,5,8,0.375
FAMBIT,Mirage,1,7,8,0.125
FAMBIT,Nuke,8,1,9,0.8888888888888888
FAMBIT,Overpass,5,4,9,0.5555555555555556
FAMBIT,Vertigo,6,2,8,0.75
FANTASY,Ancient,0,1,1,0.0
FANTASY,Dust2,2,1,3,0.6666666666666666
FANTASY,Mirage,0,1,1,0.0
FANTASY,Nuke,1,1,2,0.5
FANTASY,Overpass,2,1,3,0.6666666666666666
FATE,Ancient,2,3,5,0.4
FATE,Dust2,2,1,3,0.6666666666666666
FATE,Inferno,3,6,9,0.3333333333333333
FATE,Mirage,3,2,5,0.6
FATE,Nuke,4,3,7,0.5714285714285714
FATE,Overpass,1,4,5,0.2
FATE,Vertigo,1,1,2,0.5
FL4MUS,Inferno,0,1,1,0.0
FL4MUS,Mirage,0,1,1,0.0
FLET,Ancient,0,3,3,0.0
FLET,Dust2,2,1,3,0.6666666666666666
FLET,Mirage,2,1,3,0.6666666666666666
FLET,Nuke,2,1,3,0.6666666666666666
FLET,Overpass,1,1,2,0.5
FLET,Vertigo,2,0,2,1.0
FLINTBREEZE,Ancient,1,1,2,0.5
FLINTBREEZE,Mirage,1,0,1,1.0
FLINTBREEZE,Overpass,0,1,1,0.0
FORZE,Ancient,27,28,55,0.4909090909090909
FORZE,Anubis,5,1,6,0.8333333333333334
FORZE,Dust2,43,19,62,0.6935483870967742
FORZE,Inferno,49,36,85,0.5764705882352941
FORZE,Mirage,60,35,95,0.631578947368421
FORZE,Nuke,41,27,68,0.6029411764705882
FORZE,Overpass,43,24,67,0.6417910447761194
FORZE,Vertigo,2,1,3,0.6666666666666666
FOXED,Ancient,1,1,2,0.5
FOXED,Inferno,0,1,1,0.0
FOXED,Mirage,0,1,1,0.0
FOXED,Nuke,0,2,2,0.0
FOXED,Overpass,1,1,2,0.5
FOXED,Vertigo,0,1,1,0.0
FPL Demons,Inferno,0,1,1,0.0
FPL Demons,Overpass,0,1,1,0.0
FPLCKINGS,Inferno,0,1,1,0.0
FPLCKINGS,Mirage,0,1,1,0.0
FPSBUG,Dust2,0,2,2,0.0
FPSBUG,Inferno,1,0,1,1.0
FPSBUG,Mirage,0,1,1,0.0
FPSBUG,Nuke,1,1,2,0.5
FPSBUG,Vertigo,0,1,1,0.0
FREE THE MANDEM,Inferno,0,1,1,0.0
FREE THE MANDEM,Mirage,0,1,1,0.0
FTW,Ancient,11,15,26,0.4230769230769231
FTW,Anubis,6,1,7,0.8571428571428571
FTW,Dust2,11,11,22,0.5
FTW,Inferno,20,21,41,0.4878048780487805
FTW,Nuke,22,21,43,0.5116279069767442
FTW,Overpass,3,19,22,0.13636363636363635
FTW,Vertigo,18,21,39,0.46153846153846156
FURIA,Ancient,14,11,25,0.56
FURIA,Anubis,1,1,2,0.5
FURIA,Inferno,16,21,37,0.43243243243243246
FURIA,Mirage,23,13,36,0.6388888888888888
FURIA,Nuke,19,19,38,0.5
FURIA,Overpass,10,9,19,0.5263157894736842
FURIA,Vertigo,22,8,30,0.7333333333333333
FURIA Academy,Ancient,1,0,1,1.0
FURIA Academy,Dust2,10,10,20,0.5
FURIA Academy,Inferno,8,13,21,0.38095238095238093
FURIA Academy,Mirage,15,25,40,0.375
FURIA Academy,Nuke,13,12,25,0.52
FURIA Academy,Overpass,17,18,35,0.4857142857142857
FURIA Academy,Vertigo,10,19,29,0.3448275862068966
FURIA fe,Ancient,0,3,3,0.0
FURIA fe,Anubis,1,0,1,1.0
FURIA fe,Dust2,6,3,9,0.6666666666666666
FURIA fe,Inferno,2,0,2,1.0
FURIA fe,Mirage,15,1,16,0.9375
FURIA fe,Nuke,8,2,10,0.8
FURIA fe,Overpass,3,3,6,0.5
FURIA fe,Vertigo,4,5,9,0.4444444444444444
FURY,Ancient,2,2,4,0.5
FURY,Dust2,3,3,6,0.5
FURY,Inferno,3,2,5,0.6
FURY,Mirage,1,0,1,1.0
FURY,Nuke,2,6,8,0.25
FURY,Overpass,1,2,3,0.3333333333333333
FURY,Vertigo,2,2,4,0.5
FUSION,Ancient,1,2,3,0.3333333333333333
FUSION,Anubis,0,2,2,0.0
FUSION,Dust2,3,1,4,0.75
FUSION,Inferno,9,4,13,0.6923076923076923
FUSION,Mirage,6,3,9,0.6666666666666666
FUSION,Nuke,1,3,4,0.25
FUSION,Overpass,0,2,2,0.0
FUSION,Vertigo,0,1,1,0.0
FaZe,Ancient,23,15,38,0.6052631578947368
FaZe,Anubis,1,0,1,1.0
FaZe,Dust2,21,14,35,0.6
FaZe,Inferno,44,17,61,0.7213114754098361
FaZe,Mirage,31,22,53,0.5849056603773585
FaZe,Nuke,28,13,41,0.6829268292682927
FaZe,Overpass,20,16,36,0.5555555555555556
FaZe,Vertigo,3,0,3,1.0
Falcons,Ancient,7,3,10,0.7
Falcons,Anubis,0,1,1,0.0
Falcons,Dust2,19,10,29,0.6551724137931034
Falcons,Inferno,13,11,24,0.5416666666666666
Falcons,Mirage,11,16,27,0.4074074074074074
Falcons,Nuke,22,18,40,0.55
Falcons,Overpass,17,14,31,0.5483870967741935
Falcons,Vertigo,14,17,31,0.45161290322580644
Fantastic Seven,Ancient,2,1,3,0.6666666666666666
Fantastic Seven,Dust2,0,1,1,0.0
Fantastic Seven,Mirage,0,2,2,0.0
Fantastic Seven,Nuke,1,1,2,0.5
Fantastic Seven,Overpass,0,1,1,0.0
Fantastic Seven,Vertigo,1,0,1,1.0
Fantastyczna Piatka,Mirage,0,1,1,0.0
Fantastyczna Piatka,Nuke,0,1,1,0.0
FcottoNd,Mirage,0,1,1,0.0
FcottoNd,Overpass,0,1,1,0.0
Feenix,Ancient,1,3,4,0.25
Feenix,Dust2,1,1,2,0.5
Feenix,Inferno,0,7,7,0.0
Feenix,Nuke,3,2,5,0.6
Feenix,Overpass,0,2,2,0.0
Feenix,Vertigo,2,1,3,0.6666666666666666
Fiend,Ancient,4,4,8,0.5
Fiend,Dust2,18,8,26,0.6923076923076923
Fiend,Inferno,20,11,31,0.6451612903225806
Fiend,Mirage,23,16,39,0.5897435897435898
Fiend,Nuke,12,15,27,0.4444444444444444
Fiend,Overpass,8,5,13,0.6153846153846154
Finest,Ancient,15,23,38,0.39473684210526316
Finest,Dust2,22,22,44,0.5
Finest,Inferno,27,25,52,0.5192307692307693
Finest,Mirage,29,12,41,0.7073170731707317
Finest,Nuke,6,6,12,0.5
Finest,Overpass,39,22,61,0.639344262295082
Finest,Vertigo,23,20,43,0.5348837209302325
First Memory,Ancient,1,0,1,1.0
First Memory,Dust2,0,1,1,0.0
First Memory,Inferno,0,1,1,0.0
First Memory,Vertigo,0,2,2,0.0
Firstwave,Ancient,1,0,1,1.0
Firstwave,Inferno,0,1,1,0.0
Firstwave,Mirage,0,1,1,0.0
Firstwave,Nuke,1,1,2,0.5
Fjerritslev Gymnasium,Ancient,1,0,1,1.0
Fjerritslev Gymnasium,Mirage,1,1,2,0.5
Fjerritslev Gymnasium,Nuke,1,3,4,0.25
Fjerritslev Gymnasium,Vertigo,0,2,2,0.0
Flaggers,Inferno,0,1,1,0.0
Flamengo,Ancient,2,3,5,0.4
Flamengo,Anubis,2,1,3,0.6666666666666666
Flamengo,Inferno,4,3,7,0.5714285714285714
Flamengo,Mirage,7,2,9,0.7777777777777778
Flamengo,Nuke,2,3,5,0.4
Flamengo,Overpass,0,1,1,0.0
Flamengo,Vertigo,1,2,3,0.3333333333333333
Flames Ascent,Dust2,3,4,7,0.42857142857142855
Flames Ascent,Inferno,1,3,4,0.25
Flames Ascent,Mirage,3,5,8,0.375
Flames Ascent,Nuke,1,3,4,0.25
Flames Ascent,Overpass,3,7,10,0.3
Flames Ascent,Vertigo,0,2,2,0.0
Flames Shieldmaidens,Ancient,1,0,1,1.0
Flames Shieldmaidens,Mirage,0,1,1,0.0
Flames Shieldmaidens,Nuke,0,1,1,0.0
Flames Shieldmaidens,Vertigo,0,1,1,0.0
Fluxo,Ancient,8,8,16,0.5
Fluxo,Anubis,0,1,1,0.0
Fluxo,Dust2,19,7,26,0.7307692307692307
Fluxo,Inferno,12,6,18,0.6666666666666666
Fluxo,Mirage,18,9,27,0.6666666666666666
Fluxo,Nuke,20,6,26,0.7692307692307693
Fluxo,Overpass,2,3,5,0.4
Fluxo,Vertigo,10,3,13,0.7692307692307693
Foggy,Ancient,0,1,1,0.0
Foggy,Inferno,0,1,1,0.0
Foggy,Mirage,0,1,1,0.0
Foggy,Nuke,0,2,2,0.0
Foggy,Overpass,0,1,1,0.0
ForGlory,Inferno,1,0,1,1.0
ForGlory,Vertigo,1,0,1,1.0
Formel,Ancient,0,1,1,0.0
Formel,Dust2,0,1,1,0.0
Formel,Inferno,2,1,3,0.6666666666666666
Formel,Mirage,3,1,4,0.75
Formel,Overpass,1,2,3,0.3333333333333333
Forsaken,Inferno,0,1,1,0.0
Forsaken,Mirage,1,0,1,1.0
Forsaken,Nuke,0,1,1,0.0
Forsaken,Overpass,0,1,1,0.0
Forsaken,Vertigo,0,2,2,0.0
Forward,Ancient,8,4,12,0.6666666666666666
Forward,Anubis,1,2,3,0.3333333333333333
Forward,Dust2,4,2,6,0.6666666666666666
Forward,Inferno,5,3,8,0.625
Forward,Mirage,2,6,8,0.25
Forward,Nuke,1,3,4,0.25
Forward,Overpass,1,6,7,0.14285714285714285
Fourteen,Ancient,1,2,3,0.3333333333333333
Fourteen,Dust2,1,2,3,0.3333333333333333
Fourteen,Inferno,2,4,6,0.3333333333333333
Fourteen,Nuke,1,2,3,0.3333333333333333
Fourteen,Vertigo,1,2,3,0.3333333333333333
Fourth Quarter,Ancient,1,3,4,0.25
Fourth Quarter,Inferno,1,2,3,0.3333333333333333
Fourth Quarter,Mirage,0,1,1,0.0
Fourth Quarter,Nuke,0,2,2,0.0
Fourth Quarter,Overpass,1,2,3,0.3333333333333333
Fourth Quarter,Vertigo,3,1,4,0.75
Fragging for Jason,Ancient,1,0,1,1.0
Fragging for Jason,Mirage,1,1,2,0.5
Fragging for Jason,Nuke,0,1,1,0.0
Fragging for Jason,Vertigo,0,1,1,0.0
FreeStyle,Dust2,1,1,2,0.5
FreeStyle,Inferno,0,3,3,0.0
FreeStyle,Mirage,1,0,1,1.0
FreeStyle,Overpass,1,0,1,1.0
FreeStyle,Vertigo,0,1,1,0.0
FreeTON,Ancient,0,1,1,0.0
Freedom Fighters,Inferno,1,0,1,1.0
Freedom Fighters,Mirage,0,1,1,0.0
Freedom Fighters,Nuke,0,2,2,0.0
Freedom Fighters,Overpass,2,1,3,0.6666666666666666
Frida Gymnasiet,Ancient,0,1,1,0.0
Frida Gymnasiet,Vertigo,0,1,1,0.0
From The Grave,Mirage,0,1,1,0.0
Frontier,Dust2,0,2,2,0.0
Frontier,Inferno,2,1,3,0.6666666666666666
Frontier,Mirage,0,1,1,0.0
Frontier,Nuke,0,1,1,0.0
Frontier,Overpass,0,1,1,0.0
Frontier,Vertigo,1,1,2,0.5
FunPlus Phoenix,Ancient,2,3,5,0.4
FunPlus Phoenix,Dust2,3,6,9,0.3333333333333333
FunPlus Phoenix,Inferno,10,3,13,0.7692307692307693
FunPlus Phoenix,Nuke,8,2,10,0.8
FunPlus Phoenix,Overpass,2,4,6,0.3333333333333333
FunPlus Phoenix,Vertigo,3,6,9,0.3333333333333333
Furious,Ancient,3,2,5,0.6
Furious,Anubis,0,1,1,0.0
Furious,Dust2,12,14,26,0.46153846153846156
Furious,Inferno,5,11,16,0.3125
Furious,Mirage,8,18,26,0.3076923076923077
Furious,Nuke,15,22,37,0.40540540540540543
Furious,Overpass,6,6,12,0.5
Furious,Vertigo,9,6,15,0.6
Furious Steel,Nuke,0,1,1,0.0
Furious Steel,Vertigo,0,1,1,0.0
FuscГЈo 1500,Ancient,1,0,1,1.0
FuscГЈo 1500,Anubis,2,2,4,0.5
FuscГЈo 1500,Inferno,1,3,4,0.25
FuscГЈo 1500,Mirage,1,1,2,0.5
FuscГЈo 1500,Overpass,1,1,2,0.5
FuscГЈo 1500,Vertigo,3,0,3,1.0
FyR,Ancient,0,1,1,0.0
FyR,Dust2,0,1,1,0.0
G2,Ancient,14,8,22,0.6363636363636364
G2,Anubis,4,0,4,1.0
G2,Cobblestone,1,0,1,1.0
G2,Dust2,20,16,36,0.5555555555555556
G2,Inferno,42,17,59,0.711864406779661
G2,Mirage,28,27,55,0.509090909090909
G2,Nuke,28,13,41,0.6829268292682927
G2,Vertigo,14,16,30,0.4666666666666667
GAARDEN,Mirage,0,1,1,0.0
GAARDEN,Nuke,0,1,1,0.0
GAIJIN,Inferno,1,0,1,1.0
GAIJIN,Nuke,1,0,1,1.0
GAS,Ancient,0,2,2,0.0
GAS,Inferno,0,1,1,0.0
GAS,Mirage,0,1,1,0.0
GGPR,Dust2,2,1,3,0.6666666666666666
GGPR,Inferno,3,2,5,0.6
GGPR,Mirage,1,2,3,0.3333333333333333
GGPR,Nuke,1,4,5,0.2
GGPR,Overpass,1,1,2,0.5
GGPR,Vertigo,1,2,3,0.3333333333333333
GKC,Ancient,0,1,1,0.0
GKC,Dust2,1,1,2,0.5
GKC,Mirage,1,0,1,1.0
GKC,Nuke,0,1,1,0.0
GKC,Overpass,0,1,1,0.0
GLORE,Mirage,0,2,2,0.0
GLORE,Overpass,0,1,1,0.0
GMT,Ancient,5,2,7,0.7142857142857143
GMT,Dust2,0,2,2,0.0
GMT,Inferno,4,3,7,0.5714285714285714
GMT,Mirage,2,3,5,0.4
GMT,Nuke,0,3,3,0.0
GMT,Vertigo,2,1,3,0.6666666666666666
GO HogRiders,Inferno,0,1,1,0.0
GO HogRiders,Vertigo,0,1,1,0.0
GOATED,Mirage,1,0,1,1.0
GOATED,Vertigo,1,0,1,1.0
GODSENT,Ancient,23,13,36,0.6388888888888888
GODSENT,Dust2,2,8,10,0.2
GODSENT,Inferno,21,19,40,0.525
GODSENT,Mirage,18,13,31,0.5806451612903226
GODSENT,Nuke,17,21,38,0.4473684210526316
GODSENT,Overpass,16,11,27,0.5925925925925926
GODSENT,Vertigo,21,12,33,0.6363636363636364
GODSENT fe,Dust2,0,1,1,0.0
GODSENT fe,Inferno,0,1,1,0.0
GODSENT fe,Mirage,0,1,1,0.0
GODSENT fe,Nuke,1,0,1,1.0
GODSENT fe,Overpass,0,3,3,0.0
GODSENT fe,Vertigo,0,1,1,0.0
GORILLAZ,Ancient,1,4,5,0.2
GORILLAZ,Dust2,5,3,8,0.625
GORILLAZ,Inferno,6,7,13,0.46153846153846156
GORILLAZ,Mirage,7,7,14,0.5
GORILLAZ,Nuke,9,7,16,0.5625
GORILLAZ,Overpass,3,5,8,0.375
GR,Ancient,0,1,1,0.0
GR,Overpass,1,0,1,1.0
GRGECHI,Ancient,1,2,3,0.3333333333333333
GRGECHI,Dust2,0,1,1,0.0
GRGECHI,Inferno,0,1,1,0.0
GRGECHI,Overpass,0,2,2,0.0
GSW,Overpass,0,1,1,0.0
GSW,Vertigo,0,1,1,0.0
GTZ,Ancient,2,5,7,0.2857142857142857
GTZ,Anubis,1,6,7,0.14285714285714285
GTZ,Dust2,2,1,3,0.6666666666666666
GTZ,Inferno,6,13,19,0.3157894736842105
GTZ,Mirage,1,5,6,0.16666666666666666
GTZ,Nuke,0,3,3,0.0
GTZ,Overpass,5,6,11,0.45454545454545453
GTZ,Vertigo,4,10,14,0.2857142857142857
GUESS,Ancient,1,1,2,0.5
GUESS,Dust2,0,1,1,0.0
GUESS,Mirage,1,1,2,0.5
GUESS,Nuke,0,1,1,0.0
GUESS,Overpass,0,1,1,0.0
Gaimin Gladiators,Ancient,12,4,16,0.75
Gaimin Gladiators,Dust2,10,8,18,0.5555555555555556
Gaimin Gladiators,Inferno,23,11,34,0.6764705882352942
Gaimin Gladiators,Mirage,16,10,26,0.6153846153846154
Gaimin Gladiators,Nuke,8,4,12,0.6666666666666666
Gaimin Gladiators,Overpass,6,7,13,0.46153846153846156
Gaimin Gladiators,Vertigo,4,4,8,0.5
Galaxy Racer,Ancient,6,4,10,0.6
Galaxy Racer,Dust2,5,8,13,0.38461538461538464
Galaxy Racer,Inferno,19,6,25,0.76
Galaxy Racer,Mirage,6,5,11,0.5454545454545454
Galaxy Racer,Overpass,9,6,15,0.6
Galaxy Racer,Vertigo,2,6,8,0.25
Galaxy Racer fe,Ancient,1,0,1,1.0
Galaxy Racer fe,Dust2,1,0,1,1.0
Galaxy Racer fe,Inferno,2,0,2,1.0
Galaxy Racer fe,Mirage,1,0,1,1.0
Galaxy Racer fe,Overpass,2,0,2,1.0
Galaxy Racer fe,Vertigo,3,0,3,1.0
Gambit,Ancient,11,6,17,0.6470588235294118
Gambit,Dust2,13,7,20,0.65
Gambit,Inferno,12,11,23,0.5217391304347826
Gambit,Mirage,13,9,22,0.5909090909090909
Gambit,Overpass,11,5,16,0.6875
Gambit,Vertigo,13,7,20,0.65
Gambit 2017,Ancient,1,0,1,1.0
Gambit 2017,Dust2,1,0,1,1.0
Gambit 2017,Inferno,0,1,1,0.0
Gambit 2017,Nuke,1,0,1,1.0
Game Fist,Mirage,0,1,1,0.0
Game Fist,Nuke,0,1,1,0.0
GameAgents,Ancient,2,0,2,1.0
GameAgents,Dust2,0,1,1,0.0
GameAgents,Inferno,1,2,3,0.3333333333333333
GameAgents,Mirage,0,3,3,0.0
GameAgents,Nuke,2,0,2,1.0
GameAgents,Vertigo,0,1,1,0.0
GamePub,Dust2,0,1,1,0.0
GamePub,Inferno,0,2,2,0.0
GamePub,Mirage,0,1,1,0.0
GameSense,Dust2,0,1,1,0.0
GameSense,Inferno,0,1,1,0.0
GameSense,Vertigo,1,0,1,1.0
GamerLegion,Ancient,34,30,64,0.53125
GamerLegion,Anubis,1,0,1,1.0
GamerLegion,Dust2,1,1,2,0.5
GamerLegion,Inferno,29,25,54,0.5370370370370371
GamerLegion,Mirage,45,32,77,0.5844155844155844
GamerLegion,Nuke,21,26,47,0.44680851063829785
GamerLegion,Overpass,35,27,62,0.5645161290322581
GamerLegion,Vertigo,27,23,50,0.54
Garfie,Ancient,0,1,1,0.0
Garfie,Mirage,0,1,1,0.0
Garfie,Nuke,0,2,2,0.0
Gas Money,Ancient,0,1,1,0.0
Gas Money,Dust2,1,0,1,1.0
Gas Money,Inferno,3,1,4,0.75
Gas Money,Mirage,1,1,2,0.5
Gas Money,Nuke,3,1,4,0.75
Gas Money,Overpass,3,0,3,1.0
Gas Money,Vertigo,0,1,1,0.0
GenOne,Ancient,3,5,8,0.375
GenOne,Anubis,3,5,8,0.375
GenOne,Dust2,9,2,11,0.8181818181818182
GenOne,Inferno,6,6,12,0.5
GenOne,Nuke,4,2,6,0.6666666666666666
GenOne,Overpass,6,8,14,0.42857142857142855
GenOne,Vertigo,2,6,8,0.25
Generation of Miracles,Inferno,0,1,1,0.0
Generation of Miracles,Mirage,1,2,3,0.3333333333333333
Generation of Miracles,Overpass,1,0,1,1.0
Genk,Ancient,3,1,4,0.75
Genk,Dust2,0,1,1,0.0
Genk,Inferno,1,7,8,0.125
Genk,Mirage,2,9,11,0.18181818181818182
Genk,Nuke,5,6,11,0.45454545454545453
Genk,Overpass,3,3,6,0.5
Genk,Vertigo,3,4,7,0.42857142857142855
Germany,Ancient,1,0,1,1.0
Germany,Dust2,0,1,1,0.0
Germany,Inferno,0,1,1,0.0
Germany,Nuke,0,1,1,0.0
Germany,Overpass,1,0,1,1.0
Germany,Vertigo,1,0,1,1.0
GhostFaces,Ancient,0,1,1,0.0
GhostFaces,Inferno,1,0,1,1.0
GhostFaces,Mirage,1,1,2,0.5
Go Kill,Cobblestone,0,1,1,0.0
God's Work,Anubis,0,1,1,0.0
God's Work,Dust2,2,4,6,0.3333333333333333
God's Work,Inferno,3,3,6,0.5
God's Work,Mirage,1,1,2,0.5
God's Work,Nuke,0,1,1,0.0
God's Work,Vertigo,1,2,3,0.3333333333333333
Goliath,Dust2,2,2,4,0.5
Goliath,Inferno,4,3,7,0.5714285714285714
Goliath,Mirage,3,4,7,0.42857142857142855
Goliath,Nuke,2,1,3,0.6666666666666666
Goliath,Overpass,0,1,1,0.0
Goliath,Vertigo,2,1,3,0.6666666666666666
Good Game,Ancient,2,0,2,1.0
Good Game,Dust2,0,1,1,0.0
Good Game,Inferno,1,2,3,0.3333333333333333
Good Game,Mirage,2,1,3,0.6666666666666666
Good Game,Nuke,0,2,2,0.0
Good Game,Vertigo,0,2,2,0.0
GoodJob,Dust2,5,0,5,1.0
GoodJob,Inferno,4,3,7,0.5714285714285714
GoodJob,Mirage,5,2,7,0.7142857142857143
GoodJob,Nuke,2,1,3,0.6666666666666666
GoodJob,Overpass,1,1,2,0.5
GoodJob,Vertigo,1,1,2,0.5
Goodfellas,Ancient,3,1,4,0.75
Goodfellas,Inferno,1,1,2,0.5
Goodfellas,Mirage,0,1,1,0.0
Goodfellas,Nuke,0,1,1,0.0
Goodfellas,Overpass,2,2,4,0.5
Goodfellas,Vertigo,0,2,2,0.0
Goomba Stomp,Mirage,1,1,2,0.5
Goomba Stomp,Vertigo,0,1,1,0.0
Got Juice,Inferno,0,1,1,0.0
Got Juice,Mirage,0,1,1,0.0
Got Juice,Nuke,1,0,1,1.0
Gravity 0,Ancient,0,1,1,0.0
Gravity 0,Inferno,0,1,1,0.0
Gravity 0,Mirage,0,1,1,0.0
Gravity 0,Nuke,1,0,1,1.0
Gravity 0,Overpass,1,1,2,0.5
Grayhound,Ancient,3,1,4,0.75
Grayhound,Anubis,1,1,2,0.5
Grayhound,Dust2,5,1,6,0.8333333333333334
Grayhound,Inferno,12,5,17,0.7058823529411765
Grayhound,Mirage,3,2,5,0.6
Grayhound,Nuke,6,4,10,0.6
Grayhound,Vertigo,5,1,6,0.8333333333333334
Green Tea Party,Inferno,0,1,1,0.0
Grillska Orebro,Ancient,1,0,1,1.0
Grillska Orebro,Inferno,1,1,2,0.5
Grillska Orebro,Overpass,1,2,3,0.3333333333333333
Grillska Orebro,Vertigo,2,1,3,0.6666666666666666
Grindas,Ancient,1,0,1,1.0
Grindas,Inferno,0,1,1,0.0
Grindas,Mirage,0,1,1,0.0
Grinny Bankers,Inferno,0,1,1,0.0
Ground Zero,Ancient,6,3,9,0.6666666666666666
Ground Zero,Dust2,3,3,6,0.5
Ground Zero,Inferno,3,5,8,0.375
Ground Zero,Mirage,4,1,5,0.8
Ground Zero,Nuke,2,4,6,0.3333333333333333
Ground Zero,Overpass,1,5,6,0.16666666666666666
Gucci Squad,Ancient,2,0,2,1.0
Gucci Squad,Mirage,1,0,1,1.0
Gucci Squad,Overpass,1,0,1,1.0
Gucci Squad,Vertigo,1,0,1,1.0
HAPYJAMOT,Inferno,0,1,1,0.0
HAPYJAMOT,Mirage,1,0,1,1.0
HAPYJAMOT,Nuke,0,1,1,0.0
HAVU,Ancient,25,16,41,0.6097560975609756
HAVU,Anubis,2,3,5,0.4
HAVU,Dust2,25,21,46,0.5434782608695652
HAVU,Inferno,20,19,39,0.5128205128205128
HAVU,Mirage,23,22,45,0.5111111111111111
HAVU,Nuke,26,21,47,0.5531914893617021
HAVU,Overpass,14,18,32,0.4375
HAVU,Vertigo,0,2,2,0.0
HEADSH0T,Mirage,1,1,2,0.5
HEADSH0T,Nuke,0,1,1,0.0
HEET,Ancient,17,20,37,0.4594594594594595
HEET,Anubis,3,1,4,0.75
HEET,Dust2,32,18,50,0.64
HEET,Inferno,30,18,48,0.625
HEET,Nuke,27,17,44,0.6136363636363636
HEET,Overpass,11,22,33,0.3333333333333333
HEET,Vertigo,18,18,36,0.5
HJC,Mirage,0,1,1,0.0
HJC,Overpass,1,0,1,1.0
HJC,Vertigo,0,1,1,0.0
HONORIS,Ancient,20,14,34,0.5882352941176471
HONORIS,Anubis,0,1,1,0.0
HONORIS,Dust2,9,10,19,0.47368421052631576
HONORIS,Inferno,32,29,61,0.5245901639344263
HONORIS,Mirage,15,16,31,0.4838709677419355
HONORIS,Nuke,32,29,61,0.5245901639344263
HONORIS,Overpass,18,23,41,0.43902439024390244
HONORIS,Vertigo,17,28,45,0.37777777777777777
HOTU,Ancient,6,3,9,0.6666666666666666
HOTU,Anubis,1,0,1,1.0
HOTU,Dust2,1,3,4,0.25
HOTU,Inferno,0,2,2,0.0
HOTU,Mirage,5,6,11,0.45454545454545453
HOTU,Nuke,2,6,8,0.25
HOTU,Overpass,6,3,9,0.6666666666666666
HOTU,Vertigo,0,1,1,0.0
HSG fe,Ancient,0,1,1,0.0
HSG fe,Dust2,1,1,2,0.5
HSG fe,Inferno,2,3,5,0.4
HSG fe,Mirage,2,1,3,0.6666666666666666
HSG fe,Overpass,1,3,4,0.25
HSG fe,Vertigo,1,1,2,0.5
HUMMER,Ancient,1,0,1,1.0
HUMMER,Dust2,1,2,3,0.3333333333333333
HUMMER,Inferno,0,2,2,0.0
HUMMER,Mirage,1,0,1,1.0
HUMMER,Nuke,0,3,3,0.0
HUMMER,Overpass,1,0,1,1.0
HYDRA,Ancient,1,0,1,1.0
HYDRA,Anubis,1,0,1,1.0
HYDRA,Nuke,0,1,1,0.0
HYDRA,Overpass,0,1,1,0.0
Halal Gang,Overpass,0,1,1,0.0
Happy Mouse,Dust2,0,1,1,0.0
Happy Mouse,Inferno,1,1,2,0.5
Happy Mouse,Nuke,1,0,1,1.0
Happy Mouse,Vertigo,2,0,2,1.0
Hard,Ancient,0,1,1,0.0
Hard,Dust2,0,2,2,0.0
Hard,Inferno,2,1,3,0.6666666666666666
Hard,Mirage,1,2,3,0.3333333333333333
Hard,Overpass,0,1,1,0.0
Hard,Vertigo,0,2,2,0.0
Hatred,Ancient,0,1,1,0.0
Hatred,Dust2,0,1,1,0.0
Hatred,Inferno,1,2,3,0.3333333333333333
Hatred,Mirage,0,1,1,0.0
Hatred,Overpass,1,0,1,1.0
Hawks,Dust2,1,1,2,0.5
Hawks,Inferno,0,2,2,0.0
Hawks,Mirage,2,1,3,0.6666666666666666
Hawks,Nuke,1,1,2,0.5
Hawks,Vertigo,0,1,1,0.0
Hazard,Ancient,2,5,7,0.2857142857142857
Hazard,Dust2,2,3,5,0.4
Hazard,Inferno,3,4,7,0.42857142857142855
Hazard,Mirage,1,1,2,0.5
Hazard,Overpass,1,2,3,0.3333333333333333
Hazard,Vertigo,2,5,7,0.2857142857142857
HeadShotKings,Mirage,0,1,1,0.0
HeadShotKings,Overpass,0,1,1,0.0
Headband Klay,Ancient,0,1,1,0.0
Headband Klay,Inferno,1,0,1,1.0
Headband Klay,Mirage,1,0,1,1.0
Headband Klay,Overpass,1,0,1,1.0
Headband Klay,Vertigo,1,0,1,1.0
HeatoN's Team,Dust2,0,1,1,0.0
HeatoN's Team,Inferno,0,1,1,0.0
HeatoN's Team,Mirage,0,2,2,0.0
HeatoN's Team,Nuke,0,1,1,0.0
Heaven and Hell,Ancient,0,1,1,0.0
Heaven and Hell,Inferno,1,0,1,1.0
Heaven and Hell,Mirage,0,1,1,0.0
Heaven and Hell,Overpass,0,1,1,0.0
Heaven and Hell,Vertigo,1,1,2,0.5
Heavy,Dust2,0,1,1,0.0
Heavy,Inferno,0,1,1,0.0
HellRaisers,Ancient,1,0,1,1.0
HellRaisers,Inferno,1,2,3,0.3333333333333333
HellRaisers,Mirage,1,1,2,0.5
HellRaisers,Nuke,1,4,5,0.2
HellRaisers,Overpass,1,1,2,0.5
HellRaisers,Vertigo,1,2,3,0.3333333333333333
Hello Kitten,Inferno,2,0,2,1.0
Hello Kitten,Mirage,1,2,3,0.3333333333333333
Hello Kitten,Nuke,0,3,3,0.0
Hello Kitten,Overpass,1,1,2,0.5
Hellslayers,Ancient,2,4,6,0.3333333333333333
Hellslayers,Dust2,1,1,2,0.5
Hellslayers,Inferno,8,1,9,0.8888888888888888
Hellslayers,Mirage,5,4,9,0.5555555555555556
Hellslayers,Nuke,2,1,3,0.6666666666666666
Hellslayers,Overpass,4,4,8,0.5
Hellslayers,Vertigo,0,1,1,0.0
Heretic's Day Care,Ancient,2,0,2,1.0
Heretic's Day Care,Dust2,0,1,1,0.0
Heretic's Day Care,Nuke,1,2,3,0.3333333333333333
Heretic's Day Care,Overpass,0,2,2,0.0
Heretic's Day Care,Vertigo,0,1,1,0.0
Heroic,Ancient,14,14,28,0.5
Heroic,Anubis,0,1,1,0.0
Heroic,Dust2,1,1,2,0.5
Heroic,Inferno,34,21,55,0.6181818181818182
Heroic,Mirage,25,20,45,0.5555555555555556
Heroic,Nuke,28,21,49,0.5714285714285714
Heroic,Overpass,32,15,47,0.6808510638297872
Heroic,Vertigo,18,14,32,0.5625
High Space Tigers,Ancient,0,1,1,0.0
High Space Tigers,Nuke,0,1,1,0.0
Holkattes,Ancient,2,2,4,0.5
Holkattes,Dust2,1,3,4,0.25
Holkattes,Inferno,4,0,4,1.0
Holkattes,Mirage,1,1,2,0.5
Holkattes,Nuke,1,1,2,0.5
Homyno,Inferno,0,1,1,0.0
Homyno,Mirage,0,1,1,0.0
Hong Kong,Dust2,0,1,1,0.0
Hong Kong,Inferno,1,0,1,1.0
Hong Kong,Mirage,1,1,2,0.5
Hong Kong,Overpass,0,1,1,0.0
Honved,Dust2,1,0,1,1.0
Honved,Inferno,0,1,1,0.0
Honved,Mirage,0,1,1,0.0
Honved,Nuke,0,1,1,0.0
Honved,Overpass,1,0,1,1.0
Horizon Reapers,Dust2,0,1,1,0.0
Horizon Reapers,Inferno,0,1,1,0.0
Horizon Reapers,Mirage,1,1,2,0.5
Horizon Reapers,Overpass,1,0,1,1.0
Horizon Reapers,Vertigo,0,2,2,0.0
Hotspurs,Ancient,0,1,1,0.0
Hotspurs,Dust2,1,1,2,0.5
Hotspurs,Inferno,2,2,4,0.5
Hotspurs,Mirage,5,2,7,0.7142857142857143
Hotspurs,Nuke,0,2,2,0.0
Hotspurs,Overpass,1,4,5,0.2
Hotspurs,Vertigo,1,0,1,1.0
Hustler's University,Inferno,1,1,2,0.5
Hustler's University,Mirage,0,1,1,0.0
Hustler's University,Nuke,1,0,1,1.0
Hustler's University,Vertigo,0,1,1,0.0
Hvor Er Du Bro?,Ancient,0,1,1,0.0
Hvor Er Du Bro?,Inferno,0,2,2,0.0
Hvor Er Du Bro?,Vertigo,1,1,2,0.5
Hype,Dust2,0,2,2,0.0
Hype,Inferno,0,1,1,0.0
Hype,Mirage,0,5,5,0.0
Hype,Nuke,1,2,3,0.3333333333333333
Hype,Overpass,1,1,2,0.5
Hype,Vertigo,0,1,1,0.0
Hysteria,Dust2,1,1,2,0.5
Hysteria,Inferno,0,2,2,0.0
Hysteria,Nuke,0,2,2,0.0
Hysteria,Overpass,1,1,2,0.5
Hysteria,Vertigo,0,1,1,0.0
IESF,Mirage,2,0,2,1.0
IESF,Nuke,3,1,4,0.75
IESF,Overpass,1,0,1,1.0
IESF,Vertigo,0,1,1,0.0
IHC,Ancient,15,9,24,0.625
IHC,Anubis,3,2,5,0.6
IHC,Dust2,14,8,22,0.6363636363636364
IHC,Inferno,30,23,53,0.5660377358490566
IHC,Mirage,13,10,23,0.5652173913043478
IHC,Nuke,29,7,36,0.8055555555555556
IHC,Overpass,8,10,18,0.4444444444444444
IHC,Vertigo,0,1,1,0.0
IHOG,Dust2,0,1,1,0.0
IHOG,Inferno,0,1,1,0.0
IKIGAI,Ancient,2,0,2,1.0
IKIGAI,Mirage,1,1,2,0.5
IKIGAI,Nuke,0,2,2,0.0
IKLA,Ancient,10,5,15,0.6666666666666666
IKLA,Anubis,1,3,4,0.25
IKLA,Dust2,4,2,6,0.6666666666666666
IKLA,Inferno,10,10,20,0.5
IKLA,Mirage,19,14,33,0.5757575757575758
IKLA,Overpass,7,11,18,0.3888888888888889
IKLA,Vertigo,6,7,13,0.46153846153846156
ILIN,Ancient,0,1,1,0.0
ILIN,Inferno,2,0,2,1.0
ILIN,Mirage,0,1,1,0.0
ILIN,Nuke,2,2,4,0.5
IMMA PROBLEM,Ancient,3,0,3,1.0
IMMA PROBLEM,Dust2,0,1,1,0.0
IMMA PROBLEM,Inferno,0,2,2,0.0
IMMA PROBLEM,Nuke,0,1,1,0.0
IMMA PROBLEM,Overpass,1,1,2,0.5
IN.GAME,Ancient,0,1,1,0.0
IN.GAME,Mirage,0,1,1,0.0
INDE IRAE,Ancient,17,11,28,0.6071428571428571
INDE IRAE,Dust2,2,2,4,0.5
INDE IRAE,Inferno,11,21,32,0.34375
INDE IRAE,Mirage,17,15,32,0.53125
INDE IRAE,Nuke,14,16,30,0.4666666666666667
INDE IRAE,Overpass,5,7,12,0.4166666666666667
INDE IRAE,Vertigo,9,5,14,0.6428571428571429
INDINDA,Dust2,1,1,2,0.5
INDINDA,Mirage,1,0,1,1.0
INDINDA,Nuke,0,1,1,0.0
INDUSTRY,Ancient,0,1,1,0.0
INDUSTRY,Overpass,0,1,1,0.0
INTZ,Ancient,8,8,16,0.5
INTZ,Anubis,4,2,6,0.6666666666666666
INTZ,Dust2,7,9,16,0.4375
INTZ,Inferno,12,11,23,0.5217391304347826
INTZ,Mirage,13,10,23,0.5652173913043478
INTZ,Nuke,10,10,20,0.5
INTZ,Overpass,0,7,7,0.0
INTZ,Vertigo,6,6,12,0.5
INVSN,Ancient,0,2,2,0.0
INVSN,Anubis,2,1,3,0.6666666666666666
INVSN,Inferno,2,5,7,0.2857142857142857
INVSN,Mirage,1,3,4,0.25
INVSN,Overpass,0,3,3,0.0
INVSN,Vertigo,6,2,8,0.75
ISO,Ancient,0,1,1,0.0
ISO,Inferno,0,1,1,0.0
IUPUI Jaguars,Mirage,1,1,2,0.5
IUPUI Jaguars,Overpass,0,2,2,0.0
IUPUI Jaguars,Vertigo,1,0,1,1.0
Iberian Family,Dust2,0,1,1,0.0
Iberian Family,Mirage,1,0,1,1.0
Iberian Family,Nuke,1,1,2,0.5
Iberian Family,Overpass,1,0,1,1.0
Iberian Family,Vertigo,2,0,2,1.0
Illes Spirit,Inferno,0,1,1,0.0
Illes Spirit,Mirage,0,1,1,0.0
Illes Spirit,Nuke,0,1,1,0.0
Illes Spirit,Overpass,0,1,1,0.0
Illes Spirit,Vertigo,1,0,1,1.0
Illuminar,Ancient,9,10,19,0.47368421052631576
Illuminar,Anubis,8,4,12,0.6666666666666666
Illuminar,Dust2,12,17,29,0.41379310344827586
Illuminar,Inferno,16,11,27,0.5925925925925926
Illuminar,Mirage,23,18,41,0.5609756097560976
Illuminar,Nuke,16,15,31,0.5161290322580645
Illuminar,Overpass,23,19,42,0.5476190476190477
Illuminar,Vertigo,16,11,27,0.5925925925925926
Illyrians,Ancient,1,1,2,0.5
Illyrians,Dust2,1,1,2,0.5
Illyrians,Inferno,1,3,4,0.25
Illyrians,Mirage,2,1,3,0.6666666666666666
Illyrians,Overpass,0,1,1,0.0
Illyrians,Vertigo,2,1,3,0.6666666666666666
Imperial,Ancient,5,5,10,0.5
Imperial,Dust2,14,11,25,0.56
Imperial,Inferno,23,16,39,0.5897435897435898
Imperial,Mirage,14,13,27,0.5185185185185185
Imperial,Nuke,28,15,43,0.6511627906976745
Imperial,Overpass,18,10,28,0.6428571428571429
Imperial,Vertigo,7,13,20,0.35
Imported Talent,Inferno,1,0,1,1.0
Imported Talent,Mirage,0,1,1,0.0
Imported Talent,Overpass,0,2,2,0.0
Imported Talent,Vertigo,0,1,1,0.0
Impression,Ancient,0,1,1,0.0
Impression,Inferno,0,1,1,0.0
Impression,Mirage,0,2,2,0.0
Impression,Nuke,0,2,2,0.0
Impression,Overpass,0,1,1,0.0
Impression,Vertigo,1,2,3,0.3333333333333333
InControl,Ancient,0,3,3,0.0
InControl,Dust2,2,1,3,0.6666666666666666
InControl,Inferno,1,6,7,0.14285714285714285
InControl,Mirage,3,3,6,0.5
InControl,Nuke,6,3,9,0.6666666666666666
InControl,Overpass,2,1,3,0.6666666666666666
InControl,Vertigo,4,1,5,0.8
InTheClub,Dust2,0,1,1,0.0
InTheClub,Inferno,1,0,1,1.0
InTheClub,Overpass,0,1,1,0.0
India,Inferno,0,2,2,0.0
India,Mirage,1,0,1,1.0
Indonesia,Inferno,1,2,3,0.3333333333333333
Indonesia,Mirage,1,1,2,0.5
Indonesia,Vertigo,0,1,1,0.0
Infamous,Inferno,0,1,1,0.0
Infinite,Ancient,4,4,8,0.5
Infinite,Dust2,5,3,8,0.625
Infinite,Inferno,7,12,19,0.3684210526315789
Infinite,Mirage,4,13,17,0.23529411764705882
Infinite,Nuke,2,5,7,0.2857142857142857
Infinite,Vertigo,1,4,5,0.2
Infinity,Ancient,8,6,14,0.5714285714285714
Infinity,Dust2,6,4,10,0.6
Infinity,Inferno,4,10,14,0.2857142857142857
Infinity,Mirage,4,5,9,0.4444444444444444
Infinity,Nuke,3,9,12,0.25
Infinity,Overpass,6,2,8,0.75
Infinity,Vertigo,0,2,2,0.0
Infinity Gauntlet,Dust2,1,0,1,1.0
Infinity Gauntlet,Inferno,0,1,1,0.0
Infinity Gauntlet,Mirage,0,1,1,0.0
Infinity Gauntlet,Nuke,2,1,3,0.6666666666666666
Infinity Gauntlet,Overpass,0,1,1,0.0
Infinity Gauntlet,Vertigo,2,1,3,0.6666666666666666
Influncr,Nuke,0,1,1,0.0
Insanium,Ancient,1,0,1,1.0
Insanium,Dust2,0,2,2,0.0
Insanium,Inferno,0,2,2,0.0
Insanium,Overpass,2,2,4,0.5
Insilio,Ancient,1,1,2,0.5
Insilio,Anubis,1,0,1,1.0
Insilio,Mirage,1,0,1,1.0
Insilio,Overpass,1,0,1,1.0
Into the Bin,Inferno,1,1,2,0.5
Into the Bin,Mirage,1,1,2,0.5
Into the Bin,Nuke,0,1,1,0.0
Into the Bin,Overpass,1,0,1,1.0
Into the Bin,Vertigo,1,0,1,1.0
Into the Breach,Ancient,23,22,45,0.5111111111111111
Into the Breach,Anubis,2,3,5,0.4
Into the Breach,Dust2,3,12,15,0.2
Into the Breach,Inferno,45,38,83,0.5421686746987951
Into the Breach,Mirage,34,30,64,0.53125
Into the Breach,Nuke,32,31,63,0.5079365079365079
Into the Breach,Overpass,31,27,58,0.5344827586206896
Into the Breach,Vertigo,18,18,36,0.5
Invictus,Ancient,3,3,6,0.5
Invictus,Dust2,2,2,4,0.5
Invictus,Inferno,4,11,15,0.26666666666666666
Invictus,Mirage,1,5,6,0.16666666666666666
Invictus,Nuke,5,9,14,0.35714285714285715
Invictus,Overpass,0,1,1,0.0
Invictus,Vertigo,1,2,3,0.3333333333333333
Invictus International,Ancient,2,1,3,0.6666666666666666
Invictus International,Inferno,5,6,11,0.45454545454545453
Invictus International,Mirage,5,2,7,0.7142857142857143
Invictus International,Nuke,2,8,10,0.2
Invictus International,Overpass,0,4,4,0.0
Invictus International,Vertigo,1,1,2,0.5
Irie Legacy,Dust2,0,1,1,0.0
Irie Legacy,Inferno,1,1,2,0.5
Irie Legacy,Mirage,0,2,2,0.0
Irie Legacy,Nuke,0,1,1,0.0
Irie Legacy,Vertigo,0,2,2,0.0
Iron Blood,Ancient,5,4,9,0.5555555555555556
Iron Blood,Inferno,3,6,9,0.3333333333333333
Iron Blood,Mirage,11,10,21,0.5238095238095238
Iron Blood,Nuke,3,8,11,0.2727272727272727
Iron Blood,Overpass,7,9,16,0.4375
Iron Blood,Vertigo,7,5,12,0.5833333333333334
Iron Branch,Ancient,0,1,1,0.0
Iron Branch,Dust2,15,5,20,0.75
Iron Branch,Inferno,10,9,19,0.5263157894736842
Iron Branch,Mirage,13,7,20,0.65
Iron Branch,Nuke,2,8,10,0.2
Iron Branch,Overpass,5,4,9,0.5555555555555556
Iron Branch,Vertigo,7,4,11,0.6363636363636364
Israel,Dust2,0,2,2,0.0
Israel,Inferno,2,2,4,0.5
Israel,Mirage,1,1,2,0.5
Israel,Nuke,1,0,1,1.0
Israel,Vertigo,0,1,1,0.0
Istanbul Wildcats,Ancient,1,0,1,1.0
Istanbul Wildcats,Dust2,1,1,2,0.5
Istanbul Wildcats,Inferno,0,3,3,0.0
Istanbul Wildcats,Mirage,1,1,2,0.5
Isurus,Ancient,16,9,25,0.64
Isurus,Anubis,0,1,1,0.0
Isurus,Dust2,21,17,38,0.5526315789473685
Isurus,Inferno,24,21,45,0.5333333333333333
Isurus,Mirage,16,12,28,0.5714285714285714
Isurus,Nuke,25,24,49,0.5102040816326531
Isurus,Overpass,25,17,42,0.5952380952380952
Izako Boars,Ancient,4,3,7,0.5714285714285714
Izako Boars,Dust2,5,3,8,0.625
Izako Boars,Inferno,2,3,5,0.4
Izako Boars,Mirage,9,8,17,0.5294117647058824
Izako Boars,Nuke,7,8,15,0.4666666666666667
Izako Boars,Overpass,3,8,11,0.2727272727272727
Izako Boars,Vertigo,5,5,10,0.5
JANO,Ancient,8,8,16,0.5
JANO,Anubis,3,4,7,0.42857142857142855
JANO,Dust2,2,5,7,0.2857142857142857
JANO,Inferno,7,15,22,0.3181818181818182
JANO,Mirage,18,8,26,0.6923076923076923
JANO,Nuke,7,14,21,0.3333333333333333
JANO,Overpass,4,8,12,0.3333333333333333
JPB,Dust2,1,1,2,0.5
JPB,Inferno,2,1,3,0.6666666666666666
JPB,Mirage,0,1,1,0.0
JPB,Nuke,0,1,1,0.0
JPB,Overpass,1,1,2,0.5
JPB,Vertigo,3,0,3,1.0
JUJUTSU KAISEN,Dust2,0,1,1,0.0
JUJUTSU KAISEN,Vertigo,0,1,1,0.0
Jaegers,Dust2,0,1,1,0.0
Jaguares,Ancient,0,1,1,0.0
Jaguares,Dust2,3,3,6,0.5
Jaguares,Inferno,3,3,6,0.5
Jaguares,Mirage,2,0,2,1.0
Jaguares,Nuke,1,2,3,0.3333333333333333
Jaguares,Vertigo,1,0,1,1.0
JiJieHao,Ancient,0,2,2,0.0
JiJieHao,Dust2,0,1,1,0.0
JiJieHao,Nuke,0,1,1,0.0
JiJieHao,Overpass,0,1,1,0.0
JiJieHao,Vertigo,0,1,1,0.0
JiJieHao International,Ancient,1,3,4,0.25
JiJieHao International,Dust2,1,1,2,0.5
JiJieHao International,Inferno,4,2,6,0.6666666666666666
JiJieHao International,Mirage,3,2,5,0.6
JiJieHao International,Nuke,2,2,4,0.5
JiJieHao International,Overpass,1,0,1,1.0
JiJieHao International,Vertigo,1,0,1,1.0
John Industries,Dust2,0,1,1,0.0
John Industries,Inferno,2,0,2,1.0
John Industries,Vertigo,2,0,2,1.0
JoinTheForce,Dust2,0,1,1,0.0
JoinTheForce,Inferno,1,1,2,0.5
JoinTheForce,Mirage,1,0,1,1.0
JoinTheForce,Nuke,0,1,1,0.0
JoinTheForce,Overpass,0,2,2,0.0
JoinTheForce,Vertigo,1,0,1,1.0
Juggernauts,Ancient,4,0,4,1.0
Juggernauts,Inferno,5,3,8,0.625
Juggernauts,Mirage,3,2,5,0.6
Juggernauts,Nuke,1,1,2,0.5
Juggernauts,Overpass,1,0,1,1.0
Juggernauts,Vertigo,1,3,4,0.25
Just Swing,Dust2,0,1,1,0.0
Just Swing,Mirage,0,1,1,0.0
K10,Mirage,0,1,1,0.0
K10,Vertigo,0,1,1,0.0
K23,Ancient,29,29,58,0.5
K23,Anubis,1,1,2,0.5
K23,Dust2,30,17,47,0.6382978723404256
K23,Inferno,37,31,68,0.5441176470588235
K23,Mirage,43,31,74,0.581081081081081
K23,Nuke,29,33,62,0.46774193548387094
K23,Overpass,39,21,60,0.65
K23,Vertigo,0,2,2,0.0
KG Network,Ancient,1,0,1,1.0
KG Network,Dust2,3,2,5,0.6
KG Network,Inferno,0,1,1,0.0
KG Network,Mirage,0,1,1,0.0
KG Network,Nuke,1,0,1,1.0
KG Network,Vertigo,0,1,1,0.0
KHAN,Ancient,2,2,4,0.5
KHAN,Dust2,1,1,2,0.5
KHAN,Inferno,2,2,4,0.5
KHAN,Mirage,1,0,1,1.0
KHAN,Overpass,0,3,3,0.0
KHAN,Vertigo,0,2,2,0.0
KINGZZZ,Inferno,1,1,2,0.5
KINGZZZ,Mirage,2,1,3,0.6666666666666666
KINGZZZ,Nuke,0,1,1,0.0
KINGZZZ,Overpass,2,0,2,1.0
KJlACCHblE,Ancient,1,1,2,0.5
KJlACCHblE,Mirage,2,1,3,0.6666666666666666
KJlACCHblE,Nuke,1,0,1,1.0
KJlACCHblE,Overpass,1,0,1,1.0
KOVA,Ancient,15,19,34,0.4411764705882353
KOVA,Dust2,1,1,2,0.5
KOVA,Inferno,9,21,30,0.3
KOVA,Mirage,18,21,39,0.46153846153846156
KOVA,Nuke,36,19,55,0.6545454545454545
KOVA,Overpass,8,18,26,0.3076923076923077
KOVA,Vertigo,10,7,17,0.5882352941176471
KRAKEN,Ancient,0,1,1,0.0
KRAKEN,Dust2,0,1,1,0.0
KRAKEN,Inferno,1,1,2,0.5
KRAKEN,Mirage,1,1,2,0.5
KRAKEN,Overpass,0,1,1,0.0
KRAKEN,Vertigo,0,1,1,0.0
KTRL,Ancient,2,5,7,0.2857142857142857
KTRL,Dust2,2,6,8,0.25
KTRL,Inferno,9,6,15,0.6
KTRL,Mirage,4,6,10,0.4
KTRL,Nuke,2,2,4,0.5
KTRL,Vertigo,0,3,3,0.0
KYDAHTORA,Inferno,1,0,1,1.0
KYDAHTORA,Mirage,1,0,1,1.0
KYDAHTORA,Nuke,1,0,1,1.0
KZG,Inferno,1,3,4,0.25
KZG,Mirage,0,2,2,0.0
KZG,Overpass,1,0,1,1.0
Kalbos Egzaminas,Ancient,0,1,1,0.0
Kalbos Egzaminas,Inferno,1,1,2,0.5
Kalbos Egzaminas,Mirage,1,0,1,1.0
Kalbos Egzaminas,Nuke,0,1,1,0.0
Kanga,Ancient,0,3,3,0.0
Kanga,Dust2,2,7,9,0.2222222222222222
Kanga,Inferno,3,4,7,0.42857142857142855
Kanga,Mirage,3,11,14,0.21428571428571427
Kanga,Nuke,4,8,12,0.3333333333333333
Kanga,Overpass,2,4,6,0.3333333333333333
Kanga,Vertigo,1,2,3,0.3333333333333333
Kappa Bar,Ancient,3,4,7,0.42857142857142855
Kappa Bar,Dust2,0,2,2,0.0
Kappa Bar,Inferno,6,7,13,0.46153846153846156
Kappa Bar,Mirage,4,11,15,0.26666666666666666
Kappa Bar,Nuke,4,7,11,0.36363636363636365
Kappa Bar,Overpass,6,6,12,0.5
Kappa Bar,Vertigo,1,1,2,0.5
Karabakh Horses,Dust2,0,1,1,0.0
Karabakh Horses,Mirage,0,1,1,0.0
Kari,Dust2,1,2,3,0.3333333333333333
Kari,Inferno,0,2,2,0.0
Kari,Mirage,2,2,4,0.5
Kari,Nuke,3,2,5,0.6
Kari,Overpass,2,6,8,0.25
Kari,Vertigo,1,1,2,0.5
Katuna,Ancient,1,2,3,0.3333333333333333
Katuna,Anubis,1,2,3,0.3333333333333333
Katuna,Inferno,5,2,7,0.7142857142857143
Katuna,Mirage,2,2,4,0.5
Katuna,Overpass,3,2,5,0.6
Katuna,Vertigo,1,1,2,0.5
Kazakhstan U18,Dust2,1,0,1,1.0
Kazakhstan U18,Inferno,1,0,1,1.0
Kazakhstan U18,Mirage,0,1,1,0.0
Keyd,Ancient,2,4,6,0.3333333333333333
Keyd,Dust2,2,2,4,0.5
Keyd,Inferno,6,8,14,0.42857142857142855
Keyd,Mirage,4,3,7,0.5714285714285714
Keyd,Nuke,7,7,14,0.5
Keyd,Overpass,4,2,6,0.6666666666666666
Kings of Content,Dust2,0,2,2,0.0
Kings of Content,Inferno,2,0,2,1.0
Kings of Content,Nuke,1,1,2,0.5
Kings of Content,Overpass,1,1,2,0.5
Kings of Content,Vertigo,0,1,1,0.0
Kinship,Ancient,1,1,2,0.5
Kinship,Dust2,3,1,4,0.75
Kinship,Inferno,1,3,4,0.25
Kinship,Mirage,2,4,6,0.3333333333333333
Kinship,Nuke,2,4,6,0.3333333333333333
Kinship,Overpass,0,4,4,0.0
Kinship,Vertigo,2,6,8,0.25
Kinship Black,Ancient,1,0,1,1.0
Kinship Black,Dust2,0,1,1,0.0
Kinship Black,Inferno,1,0,1,1.0
Kinship Black,Mirage,1,1,2,0.5
Kinship Black,Vertigo,0,1,1,0.0
Kintsugi,Ancient,2,2,4,0.5
Kintsugi,Anubis,2,2,4,0.5
Kintsugi,Inferno,0,1,1,0.0
Kintsugi,Nuke,1,3,4,0.25
Kintsugi,Overpass,0,1,1,0.0
Konoha,Mirage,0,1,1,0.0
Konoha,Nuke,0,1,1,0.0
Kosovo,Dust2,0,1,1,0.0
Kosovo,Inferno,2,2,4,0.5
Kosovo,Mirage,2,0,2,1.0
Kosovo,Nuke,0,1,1,0.0
Kuruma,Dust2,0,1,1,0.0
Kuruma,Vertigo,0,1,1,0.0
Kyoto,Ancient,0,1,1,0.0
Kyoto,Dust2,0,1,1,0.0
Kyoto,Mirage,0,2,2,0.0
Kyrgyzstan U23,Dust2,0,1,1,0.0
Kyrgyzstan U23,Mirage,0,1,1,0.0
LA COCONETA,Overpass,0,1,1,0.0
LAG,Inferno,0,1,1,0.0
LAG,Mirage,1,0,1,1.0
LAG,Vertigo,0,1,1,0.0
LAKAKA,Ancient,0,1,1,0.0
LAKAKA,Inferno,1,0,1,1.0
LAKAKA,Nuke,0,1,1,0.0
LAKAKA,Vertigo,1,0,1,1.0
LAN KRAEM,Inferno,0,1,1,0.0
LAN KRAEM,Overpass,0,1,1,0.0
LBS Helsingborg,Ancient,1,0,1,1.0
LBS Helsingborg,Overpass,1,0,1,1.0
LBS Helsingborg,Vertigo,2,0,2,1.0
LDLC,Ancient,8,19,27,0.2962962962962963
LDLC,Anubis,3,1,4,0.75
LDLC,Dust2,16,14,30,0.5333333333333333
LDLC,Inferno,23,25,48,0.4791666666666667
LDLC,Mirage,9,14,23,0.391304347826087
LDLC,Nuke,39,18,57,0.6842105263157895
LDLC,Overpass,9,10,19,0.47368421052631576
LDLC,Vertigo,11,22,33,0.3333333333333333
LF0,Dust2,1,2,3,0.3333333333333333
LF0,Inferno,1,2,3,0.3333333333333333
LF0,Nuke,1,3,4,0.25
LF0,Overpass,0,2,2,0.0
LF0,Vertigo,0,1,1,0.0
LGG,Ancient,3,0,3,1.0
LGG,Mirage,2,1,3,0.6666666666666666
LGG,Nuke,0,1,1,0.0
LGG,Overpass,0,1,1,0.0
LGG Eclipse,Dust2,0,1,1,0.0
LGG Eclipse,Inferno,0,1,1,0.0
LGG Eclipse,Overpass,1,0,1,1.0
LGG Eclipse,Vertigo,1,0,1,1.0
LGG Gentlemen,Overpass,0,1,1,0.0
LGG Snakes Den,Ancient,1,0,1,1.0
LGG Snakes Den,Dust2,1,0,1,1.0
LGG Snakes Den,Inferno,1,0,1,1.0
LGG Snakes Den,Mirage,0,1,1,0.0
LGG Snakes Den,Nuke,2,0,2,1.0
LGG Snakes Den,Overpass,3,1,4,0.75
LGG Snakes Den,Vertigo,0,1,1,0.0
LIBERTATEM,Overpass,0,1,1,0.0
LIBERTATEM,Vertigo,0,1,1,0.0
LIBURNA,Ancient,0,1,1,0.0
LIBURNA,Anubis,0,1,1,0.0
LIBURNA,Dust2,0,1,1,0.0
LIBURNA,Inferno,0,1,1,0.0
LIBURNA,Mirage,2,2,4,0.5
LIBURNA,Overpass,1,2,3,0.3333333333333333
LINKDOWN,Inferno,1,0,1,1.0
LINKDOWN,Mirage,1,2,3,0.3333333333333333
LINKDOWN,Nuke,0,1,1,0.0
LINKDOWN,Overpass,0,1,1,0.0
LINKDOWN,Vertigo,0,1,1,0.0
LODIS,Ancient,0,1,1,0.0
LPSP,Inferno,1,1,2,0.5
LPSP,Mirage,0,1,1,0.0
LPSP,Nuke,2,0,2,1.0
LPSP,Overpass,0,1,1,0.0
LSC,Ancient,0,1,1,0.0
LSC,Dust2,1,3,4,0.25
LSC,Inferno,0,1,1,0.0
LSC,Vertigo,2,0,2,1.0
LV.NEW,Dust2,1,0,1,1.0
LV.NEW,Inferno,0,1,1,0.0
LV.NEW,Mirage,0,1,1,0.0
LV.NEW,Vertigo,1,0,1,1.0
LakeShow,Inferno,0,2,2,0.0
LakeShow,Mirage,2,1,3,0.6666666666666666
LakeShow,Nuke,1,1,2,0.5
Last Bullets,Dust2,0,1,1,0.0
Last Bullets,Vertigo,0,1,1,0.0
LastWind,Inferno,0,3,3,0.0
LastWind,Mirage,0,3,3,0.0
LastWind,Nuke,1,0,1,1.0
LastWind,Overpass,1,0,1,1.0
LastWind,Vertigo,1,2,3,0.3333333333333333
Lausanne SE,Ancient,0,1,1,0.0
Lausanne SE,Dust2,2,2,4,0.5
Lausanne SE,Inferno,4,1,5,0.8
Lausanne SE,Mirage,2,1,3,0.6666666666666666
Lausanne SE,Nuke,2,0,2,1.0
Lausanne SE,Overpass,1,1,2,0.5
Lausanne SE,Vertigo,2,0,2,1.0
Lavender,Mirage,0,1,1,0.0
Lavender,Nuke,1,0,1,1.0
Lavender,Overpass,0,1,1,0.0
Lazer Cats,Ancient,2,0,2,1.0
Lazer Cats,Anubis,1,0,1,1.0
Lazer Cats,Mirage,0,2,2,0.0
Lazer Cats,Nuke,1,2,3,0.3333333333333333
LeeK,Ancient,0,1,1,0.0
LeeK,Dust2,1,1,2,0.5
LeeK,Inferno,0,1,1,0.0
LeeK,Mirage,0,1,1,0.0
LeeK,Nuke,1,0,1,1.0
LeeK,Overpass,0,1,1,0.0
Legates,Mirage,0,1,1,0.0
Legates,Nuke,0,1,1,0.0
Legendary,Mirage,0,1,1,0.0
Leicester 5,Mirage,0,1,1,0.0
Leicester 5,Nuke,0,2,2,0.0
Leicester 5,Vertigo,0,1,1,0.0
Lemondogs,Ancient,2,2,4,0.5
Lemondogs,Dust2,2,0,2,1.0
Lemondogs,Inferno,1,4,5,0.2
Lemondogs,Mirage,2,3,5,0.4
Lemondogs,Nuke,0,1,1,0.0
Lemondogs,Overpass,1,1,2,0.5
Leo,Nuke,0,2,2,0.0
Leo,Overpass,0,1,1,0.0
Leo,Vertigo,0,2,2,0.0
Lese,Ancient,2,2,4,0.5
Lese,Dust2,1,3,4,0.25
Lese,Inferno,2,1,3,0.6666666666666666
Lese,Mirage,0,3,3,0.0
Lese,Nuke,1,4,5,0.2
Lese,Overpass,1,2,3,0.3333333333333333
Lese,Vertigo,0,2,2,0.0
Let us cook,Ancient,0,1,1,0.0
Let us cook,Inferno,0,1,1,0.0
Let us cook,Mirage,1,1,2,0.5
Let us cook,Nuke,1,2,3,0.3333333333333333
Let us cook,Overpass,2,1,3,0.6666666666666666
Let us cook,Vertigo,4,2,6,0.6666666666666666
Let's Quit,Dust2,0,1,1,0.0
Let's Quit,Inferno,1,0,1,1.0
Let's Quit,Vertigo,0,1,1,0.0
Levadia,Dust2,5,4,9,0.5555555555555556
Levadia,Inferno,2,3,5,0.4
Levadia,Mirage,6,5,11,0.5454545454545454
Levadia,Nuke,2,2,4,0.5
Levadia,Overpass,1,4,5,0.2
Levadia,Vertigo,2,2,4,0.5
Level,Dust2,0,1,1,0.0
Level,Inferno,0,1,1,0.0
Levendi,Inferno,0,1,1,0.0
Levendi,Vertigo,0,1,1,0.0
Leviatan,Dust2,9,9,18,0.5
Leviatan,Inferno,18,14,32,0.5625
Leviatan,Mirage,6,1,7,0.8571428571428571
Leviatan,Nuke,8,11,19,0.42105263157894735
Leviatan,Overpass,10,7,17,0.5882352941176471
Leviatan,Vertigo,4,3,7,0.5714285714285714
Leviatan SSJ,Inferno,0,1,1,0.0
Levitate,Ancient,1,0,1,1.0
Levitate,Dust2,1,0,1,1.0
Levitate,Inferno,1,7,8,0.125
Levitate,Mirage,2,2,4,0.5
Levitate,Nuke,1,4,5,0.2
Levitate,Overpass,4,4,8,0.5
Levitate,Vertigo,3,4,7,0.42857142857142855
Liberty,Ancient,6,5,11,0.5454545454545454
Liberty,Dust2,14,6,20,0.7
Liberty,Inferno,4,9,13,0.3076923076923077
Liberty,Mirage,3,6,9,0.3333333333333333
Liberty,Nuke,6,12,18,0.3333333333333333
Liberty,Overpass,15,6,21,0.7142857142857143
Liberty,Vertigo,13,9,22,0.5909090909090909
Liberty fe,Ancient,1,0,1,1.0
Liberty fe,Dust2,1,2,3,0.3333333333333333
Liberty fe,Mirage,2,2,4,0.5
Liberty fe,Overpass,0,1,1,0.0
Liberty fe,Vertigo,2,1,3,0.6666666666666666
Lilmix,Ancient,8,12,20,0.4
Lilmix,Anubis,0,1,1,0.0
Lilmix,Dust2,4,4,8,0.5
Lilmix,Inferno,12,11,23,0.5217391304347826
Lilmix,Mirage,14,12,26,0.5384615384615384
Lilmix,Nuke,1,5,6,0.16666666666666666
Lilmix,Overpass,6,15,21,0.2857142857142857
Lilmix,Vertigo,2,5,7,0.2857142857142857
Limitless,Ancient,5,8,13,0.38461538461538464
Limitless,Anubis,1,1,2,0.5
Limitless,Dust2,3,5,8,0.375
Limitless,Inferno,7,6,13,0.5384615384615384
Limitless,Mirage,3,10,13,0.23076923076923078
Limitless,Nuke,7,12,19,0.3684210526315789
Limitless,Overpass,10,10,20,0.5
Limitless,Vertigo,7,6,13,0.5384615384615384
Linx Legacy,Ancient,2,3,5,0.4
Linx Legacy,Inferno,1,5,6,0.16666666666666666
Linx Legacy,Mirage,1,3,4,0.25
Linx Legacy,Nuke,3,2,5,0.6
Linx Legacy,Overpass,5,0,5,1.0
Linx Legacy,Vertigo,0,1,1,0.0
Lions,Mirage,0,2,2,0.0
Lions,Overpass,0,1,1,0.0
Liquid,Ancient,18,11,29,0.6206896551724138
Liquid,Anubis,4,4,8,0.5
Liquid,Dust2,12,13,25,0.48
Liquid,Inferno,30,25,55,0.5454545454545454
Liquid,Mirage,32,12,44,0.7272727272727273
Liquid,Nuke,6,10,16,0.375
Liquid,Overpass,22,13,35,0.6285714285714286
Liquid,Vertigo,23,17,40,0.575
Little Bocks,Inferno,2,0,2,1.0
Little Bocks,Mirage,0,2,2,0.0
Little Bocks,Nuke,0,1,1,0.0
Little Bocks,Overpass,2,3,5,0.4
Little Bocks,Vertigo,0,2,2,0.0
Little Socks,Mirage,0,1,1,0.0
Little Socks,Overpass,0,1,1,0.0
Lonnies drenge,Ancient,0,1,1,0.0
Lonnies drenge,Dust2,0,1,1,0.0
Lonnies drenge,Inferno,0,1,1,0.0
Lonnies drenge,Vertigo,0,1,1,0.0
Looking For Org,Ancient,11,7,18,0.6111111111111112
Looking For Org,Dust2,13,11,24,0.5416666666666666
Looking For Org,Inferno,9,14,23,0.391304347826087
Looking For Org,Mirage,1,2,3,0.3333333333333333
Looking For Org,Nuke,20,10,30,0.6666666666666666
Looking For Org,Overpass,20,11,31,0.6451612903225806
Looking For Org,Vertigo,15,12,27,0.5555555555555556
LookingForAnOrg,Inferno,0,1,1,0.0
LookingForAnOrg,Nuke,1,1,2,0.5
Lord Rabbit,Ancient,1,1,2,0.5
Lord Rabbit,Anubis,0,2,2,0.0
Lord Rabbit,Dust2,0,1,1,0.0
Lord Rabbit,Inferno,3,3,6,0.5
Lord Rabbit,Mirage,2,2,4,0.5
Lord Rabbit,Nuke,0,1,1,0.0
Lord Rabbit,Vertigo,1,0,1,1.0
Los Grandes,Ancient,0,2,2,0.0
Los Grandes,Dust2,7,5,12,0.5833333333333334
Los Grandes,Inferno,6,9,15,0.4
Los Grandes,Mirage,0,4,4,0.0
Los Grandes,Nuke,1,2,3,0.3333333333333333
Los Grandes,Overpass,5,3,8,0.625
Los Grandes,Vertigo,0,3,3,0.0
Los Grandes Academy,Ancient,0,2,2,0.0
Los Grandes Academy,Dust2,1,6,7,0.14285714285714285
Los Grandes Academy,Inferno,0,6,6,0.0
Los Grandes Academy,Mirage,8,4,12,0.6666666666666666
Los Grandes Academy,Nuke,1,4,5,0.2
Los Grandes Academy,Overpass,0,5,5,0.0
Los Grandes Academy,Vertigo,0,1,1,0.0
Los Grandes Community,Mirage,0,1,1,0.0
Los Grandes Community,Overpass,0,1,1,0.0
Los Reyes,Ancient,2,4,6,0.3333333333333333
Los Reyes,Inferno,6,3,9,0.6666666666666666
Los Reyes,Mirage,2,1,3,0.6666666666666666
Los Reyes,Nuke,3,4,7,0.42857142857142855
Los Reyes,Overpass,2,4,6,0.3333333333333333
Los Reyes,Vertigo,4,1,5,0.8
Loto,Ancient,1,0,1,1.0
Loto,Dust2,0,1,1,0.0
Loto,Inferno,1,0,1,1.0
Loto,Mirage,0,1,1,0.0
Loto,Nuke,1,0,1,1.0
Loto,Overpass,0,2,2,0.0
LowLandLions,Ancient,1,3,4,0.25
LowLandLions,Dust2,0,1,1,0.0
LowLandLions,Inferno,4,3,7,0.5714285714285714
LowLandLions,Mirage,5,5,10,0.5
LowLandLions,Nuke,3,2,5,0.6
LowLandLions,Overpass,2,0,2,1.0
LowLandLions,Vertigo,6,3,9,0.6666666666666666
Lucent,Ancient,1,0,1,1.0
Lucent,Inferno,0,2,2,0.0
Lucent,Nuke,0,1,1,0.0
Lucent,Vertigo,0,1,1,0.0
Luxe,Dust2,0,1,1,0.0
Luxe,Inferno,1,1,2,0.5
Luxe,Mirage,2,1,3,0.6666666666666666
Luxe,Nuke,1,1,2,0.5
Luxe,Overpass,2,2,4,0.5
Luxe,Vertigo,4,0,4,1.0
Luxembourg,Dust2,0,1,1,0.0
Luxembourg,Inferno,0,1,1,0.0
Luxembourg,Vertigo,0,1,1,0.0
LyP,Dust2,1,1,2,0.5
LyP,Inferno,0,1,1,0.0
LyP,Nuke,2,1,3,0.6666666666666666
Lyngby Vikings,Ancient,14,4,18,0.7777777777777778
Lyngby Vikings,Dust2,5,7,12,0.4166666666666667
Lyngby Vikings,Inferno,18,8,26,0.6923076923076923
Lyngby Vikings,Mirage,4,7,11,0.36363636363636365
Lyngby Vikings,Nuke,7,6,13,0.5384615384615384
Lyngby Vikings,Overpass,7,6,13,0.5384615384615384
Lyngby Vikings,Vertigo,26,6,32,0.8125
Lynn Vision,Ancient,13,11,24,0.5416666666666666
Lynn Vision,Anubis,3,4,7,0.42857142857142855
Lynn Vision,Dust2,12,14,26,0.46153846153846156
Lynn Vision,Inferno,16,19,35,0.45714285714285713
Lynn Vision,Mirage,1,0,1,1.0
Lynn Vision,Nuke,25,20,45,0.5555555555555556
Lynn Vision,Overpass,23,8,31,0.7419354838709677
Lynn Vision,Vertigo,13,6,19,0.6842105263157895
M1,Ancient,0,2,2,0.0
M1,Dust2,0,2,2,0.0
M1,Inferno,0,1,1,0.0
M1,Mirage,0,1,1,0.0
M1,Nuke,0,4,4,0.0
M1,Overpass,1,0,1,1.0
M1,Vertigo,0,1,1,0.0
MAD Lions,Ancient,19,12,31,0.6129032258064516
MAD Lions,Dust2,22,9,31,0.7096774193548387
MAD Lions,Inferno,23,18,41,0.5609756097560976
MAD Lions,Mirage,22,16,38,0.5789473684210527
MAD Lions,Nuke,17,15,32,0.53125
MAD Lions,Overpass,14,9,23,0.6086956521739131
MAD Lions,Vertigo,1,1,2,0.5
MALCO,Mirage,0,1,1,0.0
MALCO,Overpass,0,1,1,0.0
MANS NOT HOT,Dust2,0,1,1,0.0
MANS NOT HOT,Vertigo,0,1,1,0.0
MASONIC,Ancient,28,29,57,0.49122807017543857
MASONIC,Anubis,2,0,2,1.0
MASONIC,Dust2,14,21,35,0.4
MASONIC,Inferno,43,44,87,0.4942528735632184
MASONIC,Mirage,2,9,11,0.18181818181818182
MASONIC,Nuke,38,31,69,0.5507246376811594
MASONIC,Overpass,41,28,69,0.5942028985507246
MASONIC,Vertigo,48,27,75,0.64
MAXIMA,Inferno,1,2,3,0.3333333333333333
MAXIMA,Mirage,0,1,1,0.0
MAXIMA,Nuke,0,1,1,0.0
MAXIMA,Overpass,1,0,1,1.0
MCE,Mirage,0,1,1,0.0
MCE,Nuke,1,0,1,1.0
MCE,Overpass,1,0,1,1.0
MEGAZORD,Ancient,0,1,1,0.0
MEGAZORD,Dust2,0,3,3,0.0
MEGAZORD,Inferno,2,1,3,0.6666666666666666
MEGAZORD,Mirage,2,2,4,0.5
MEGAZORD,Nuke,1,1,2,0.5
MEGAZORD,Overpass,0,3,3,0.0
MEGAZORD,Vertigo,2,1,3,0.6666666666666666
MIBR,Ancient,25,18,43,0.5813953488372093
MIBR,Anubis,9,4,13,0.6923076923076923
MIBR,Cobblestone,0,1,1,0.0
MIBR,Dust2,33,19,52,0.6346153846153846
MIBR,Inferno,34,30,64,0.53125
MIBR,Mirage,7,11,18,0.3888888888888889
MIBR,Nuke,38,28,66,0.5757575757575758
MIBR,Overpass,26,19,45,0.5777777777777777
MIBR,Vertigo,37,19,56,0.6607142857142857
MIBR Academy,Ancient,1,2,3,0.3333333333333333
MIBR Academy,Anubis,0,1,1,0.0
MIBR Academy,Dust2,4,9,13,0.3076923076923077
MIBR Academy,Inferno,5,9,14,0.35714285714285715
MIBR Academy,Mirage,11,16,27,0.4074074074074074
MIBR Academy,Nuke,9,11,20,0.45
MIBR Academy,Overpass,11,9,20,0.55
MIBR Academy,Vertigo,2,3,5,0.4
MIBR fe,Anubis,1,0,1,1.0
MIBR fe,Dust2,3,2,5,0.6
MIBR fe,Inferno,3,3,6,0.5
MIBR fe,Mirage,0,3,3,0.0
MIBR fe,Nuke,0,3,3,0.0
MIBR fe,Overpass,2,1,3,0.6666666666666666
MIBR fe,Vertigo,1,4,5,0.2
MILF,Ancient,1,0,1,1.0
MILF,Anubis,1,0,1,1.0
MILF,Inferno,1,1,2,0.5
MILF,Overpass,0,1,1,0.0
MIRACLE RUN,Ancient,0,1,1,0.0
MIRACLE RUN,Mirage,1,2,3,0.3333333333333333
MIRACLE RUN,Nuke,1,1,2,0.5
MIRACLE RUN,Vertigo,1,1,2,0.5
MIRAI,Dust2,1,0,1,1.0
MIRAI,Inferno,0,1,1,0.0
MIRAI,Nuke,0,1,1,0.0
MIXALA,Inferno,0,1,1,0.0
MIXJAYS,Nuke,0,1,1,0.0
MOB,Ancient,1,0,1,1.0
MOB,Dust2,4,2,6,0.6666666666666666
MOB,Inferno,2,4,6,0.3333333333333333
MOB,Mirage,2,1,3,0.6666666666666666
MOB,Nuke,1,2,3,0.3333333333333333
MONAD,Dust2,0,1,1,0.0
MONAD,Inferno,1,1,2,0.5
MONAD,Mirage,0,1,1,0.0
MONAD,Vertigo,0,1,1,0.0
MONKE,Ancient,1,1,2,0.5
MONKE,Inferno,0,1,1,0.0
MONKE,Mirage,2,1,3,0.6666666666666666
MONKE,Nuke,1,0,1,1.0
MONKE,Vertigo,0,1,1,0.0
MOONBOYS,Inferno,1,1,2,0.5
MOREKATS,Dust2,0,1,1,0.0
MOREKATS,Mirage,0,1,1,0.0
MOUZ,Ancient,22,12,34,0.6470588235294118
MOUZ,Dust2,4,6,10,0.4
MOUZ,Inferno,24,25,49,0.4897959183673469
MOUZ,Mirage,25,20,45,0.5555555555555556
MOUZ,Nuke,26,19,45,0.5777777777777777
MOUZ,Overpass,8,6,14,0.5714285714285714
MOUZ,Vertigo,15,11,26,0.5769230769230769
MOUZ NXT,Ancient,23,18,41,0.5609756097560976
MOUZ NXT,Dust2,11,6,17,0.6470588235294118
MOUZ NXT,Inferno,26,22,48,0.5416666666666666
MOUZ NXT,Mirage,49,23,72,0.6805555555555556
MOUZ NXT,Nuke,37,20,57,0.6491228070175439
MOUZ NXT,Overpass,13,6,19,0.6842105263157895
MOUZ NXT,Vertigo,40,17,57,0.7017543859649122
Mad Kings,Ancient,7,7,14,0.5
Mad Kings,Dust2,0,3,3,0.0
Mad Kings,Inferno,6,10,16,0.375
Mad Kings,Mirage,4,7,11,0.36363636363636365
Mad Kings,Nuke,0,3,3,0.0
Mad Kings,Overpass,2,6,8,0.25
Mad Kings,Vertigo,2,8,10,0.2
Made in Ukraine,Overpass,0,1,1,0.0
Magic School Bus,Ancient,0,4,4,0.0
Magic School Bus,Dust2,4,2,6,0.6666666666666666
Magic School Bus,Inferno,1,3,4,0.25
Magic School Bus,Mirage,3,5,8,0.375
Magic School Bus,Nuke,1,2,3,0.3333333333333333
Magic School Bus,Vertigo,0,3,3,0.0
MagicLight,Mirage,0,1,1,0.0
Maikelele's Team,Dust2,2,0,2,1.0
Maikelele's Team,Mirage,2,0,2,1.0
Maikelele's Team,Nuke,2,1,3,0.6666666666666666
Maikelele's Team,Vertigo,0,1,1,0.0
Majestic Foghorns,Anubis,2,0,2,1.0
Majestic Foghorns,Inferno,2,1,3,0.6666666666666666
Majestic Foghorns,Mirage,1,0,1,1.0
Majestic Foghorns,Nuke,0,2,2,0.0
Majestic Foghorns,Vertigo,0,1,1,0.0
Malvinas,Ancient,0,1,1,0.0
Malvinas,Dust2,1,3,4,0.25
Malvinas,Inferno,1,6,7,0.14285714285714285
Malvinas,Nuke,5,6,11,0.45454545454545453
Malvinas,Overpass,3,1,4,0.75
Malvinas,Vertigo,0,2,2,0.0
Married to the Cookies,Nuke,0,1,1,0.0
Marskalk,Ancient,1,0,1,1.0
Marskalk,Inferno,1,0,1,1.0
Marskalk,Overpass,2,1,3,0.6666666666666666
Marten,Ancient,3,1,4,0.75
Marten,Dust2,1,5,6,0.16666666666666666
Marten,Inferno,2,12,14,0.14285714285714285
Marten,Mirage,5,2,7,0.7142857142857143
Marten,Nuke,1,2,3,0.3333333333333333
Marten,Vertigo,0,3,3,0.0
Marten Rising,Ancient,1,1,2,0.5
Marten Rising,Dust2,0,1,1,0.0
Marten Rising,Inferno,0,3,3,0.0
Marten Rising,Mirage,1,0,1,1.0
Marten Rising,Overpass,0,1,1,0.0
Marten Rising,Vertigo,0,1,1,0.0
MayBe,Nuke,0,2,2,0.0
Mazaalai,Dust2,0,1,1,0.0
Mazaalai,Inferno,0,1,1,0.0
Mazaalai,Mirage,0,1,1,0.0
Mazaalai,Nuke,0,1,1,0.0
Meat Grinders,Dust2,0,1,1,0.0
Meat Grinders,Inferno,0,3,3,0.0
Meat Grinders,Mirage,1,1,2,0.5
Meat Grinders,Nuke,1,0,1,1.0
Meat Grinders,Vertigo,0,1,1,0.0
Medieval,Mirage,0,1,1,0.0
Medieval,Nuke,0,1,1,0.0
Medieval,Vertigo,0,2,2,0.0
Meinser,Dust2,0,1,1,0.0
Meinser,Mirage,0,1,1,0.0
Meta,Ancient,15,8,23,0.6521739130434783
Meta,Anubis,2,0,2,1.0
Meta,Dust2,9,14,23,0.391304347826087
Meta,Inferno,25,16,41,0.6097560975609756
Meta,Mirage,14,23,37,0.3783783783783784
Meta,Nuke,17,24,41,0.4146341463414634
Meta,Overpass,0,1,1,0.0
Meta,Vertigo,10,4,14,0.7142857142857143
Meta Academy,Ancient,3,1,4,0.75
Meta Academy,Dust2,0,4,4,0.0
Meta Academy,Inferno,2,2,4,0.5
Meta Academy,Mirage,1,2,3,0.3333333333333333
Meta Academy,Nuke,4,5,9,0.4444444444444444
Meta Academy,Overpass,0,1,1,0.0
Meta Academy,Vertigo,0,1,1,0.0
Meta PY,Ancient,0,1,1,0.0
Meta PY,Dust2,0,1,1,0.0
Meta4Pro,Dust2,1,2,3,0.3333333333333333
Meta4Pro,Mirage,1,1,2,0.5
Meta4Pro,Nuke,0,1,1,0.0
Meta4Pro,Vertigo,0,2,2,0.0
Metizport,Ancient,1,1,2,0.5
Metizport,Inferno,1,1,2,0.5
Metizport,Mirage,0,1,1,0.0
Metizport,Nuke,0,1,1,0.0
Metizport,Overpass,0,2,2,0.0
Metizport,Vertigo,0,2,2,0.0
Mexico,Inferno,0,1,1,0.0
Mexico,Mirage,0,1,1,0.0
Midgard,Ancient,0,1,1,0.0
Midgard,Inferno,0,1,1,0.0
Midgard,Mirage,0,1,1,0.0
Midgard,Nuke,0,1,1,0.0
Midgard,Overpass,0,2,2,0.0
Mindfreak,Ancient,0,1,1,0.0
Mindfreak,Inferno,1,3,4,0.25
Mindfreak,Mirage,1,1,2,0.5
Mindfreak,Overpass,0,1,1,0.0
Mindfreak,Vertigo,0,1,1,0.0
MixUA,Ancient,0,1,1,0.0
MixUA,Mirage,0,1,1,0.0
MixUA,Overpass,1,0,1,1.0
Mixfits,Ancient,1,1,2,0.5
Mixfits,Anubis,3,4,7,0.42857142857142855
Mixfits,Inferno,2,7,9,0.2222222222222222
Mixfits,Nuke,3,3,6,0.5
Mixfits,Overpass,3,2,5,0.6
Mixfits,Vertigo,2,3,5,0.4
Monarchy,Ancient,0,1,1,0.0
Monarchy,Inferno,1,1,2,0.5
Monarchy,Mirage,0,2,2,0.0
Monarchy,Nuke,0,1,1,0.0
Monarchy,Vertigo,1,0,1,1.0
MonaspA,Dust2,1,0,1,1.0
MonaspA,Inferno,1,0,1,1.0
MongolZ,Mirage,0,1,1,0.0
MongolZ,Vertigo,0,1,1,0.0
Monkey Business,Dust2,1,1,2,0.5
Monkey Business,Inferno,1,0,1,1.0
Monkey Business,Mirage,0,2,2,0.0
Monkey Business,Nuke,1,1,2,0.5
Monte,Ancient,13,10,23,0.5652173913043478
Monte,Anubis,13,2,15,0.8666666666666667
Monte,Dust2,11,10,21,0.5238095238095238
Monte,Inferno,1,0,1,1.0
Monte,Mirage,34,14,48,0.7083333333333334
Monte,Nuke,20,17,37,0.5405405405405406
Monte,Overpass,7,6,13,0.5384615384615384
Monte,Vertigo,11,7,18,0.6111111111111112
Monte Carlo,Dust2,0,1,1,0.0
Monte Carlo,Overpass,0,1,1,0.0
Montecarlo,Ancient,0,1,1,0.0
Montenegro,Inferno,0,1,1,0.0
Montenegro,Mirage,1,0,1,1.0
Moon,Dust2,0,1,1,0.0
Moon,Inferno,0,1,1,0.0
Moon,Nuke,0,2,2,0.0
Moon,Vertigo,0,2,2,0.0
Moralezz,Ancient,1,0,1,1.0
Moralezz,Dust2,0,3,3,0.0
Moralezz,Inferno,0,1,1,0.0
Moralezz,Mirage,3,0,3,1.0
Moralezz,Nuke,2,0,2,1.0
Moralezz,Overpass,0,2,2,0.0
Moralezz,Vertigo,0,2,2,0.0
Moratur,Ancient,0,1,1,0.0
Moratur,Mirage,0,2,2,0.0
Moratur,Overpass,0,1,1,0.0
Morbin5,Dust2,0,1,1,0.0
Morbin5,Inferno,1,1,2,0.5
Morbin5,Mirage,0,1,1,0.0
Morbin5,Nuke,0,1,1,0.0
MostValuablePlayers,Dust2,0,1,1,0.0
MostValuablePlayers,Inferno,0,1,1,0.0
MostValuablePlayers,Mirage,2,1,3,0.6666666666666666
MostValuablePlayers,Nuke,2,0,2,1.0
MostValuablePlayers,Overpass,1,1,2,0.5
MostValuablePlayers,Vertigo,1,1,2,0.5
Movistar Riders,Ancient,11,21,32,0.34375
Movistar Riders,Anubis,0,3,3,0.0
Movistar Riders,Dust2,0,1,1,0.0
Movistar Riders,Inferno,26,21,47,0.5531914893617021
Movistar Riders,Mirage,15,27,42,0.35714285714285715
Movistar Riders,Nuke,35,25,60,0.5833333333333334
Movistar Riders,Overpass,20,19,39,0.5128205128205128
Movistar Riders,Vertigo,25,25,50,0.5
Mystic,Ancient,1,1,2,0.5
Mystic,Inferno,0,1,1,0.0
Mystic,Mirage,1,1,2,0.5
Mystic,Nuke,1,1,2,0.5
Mystic,Overpass,0,1,1,0.0
Mystic,Vertigo,2,1,3,0.6666666666666666
Mystique,Overpass,0,1,1,0.0
Mystique,Vertigo,0,1,1,0.0
Mythic,Ancient,8,11,19,0.42105263157894735
Mythic,Anubis,0,2,2,0.0
Mythic,Dust2,4,10,14,0.2857142857142857
Mythic,Inferno,18,18,36,0.5
Mythic,Mirage,10,17,27,0.37037037037037035
Mythic,Nuke,2,5,7,0.2857142857142857
Mythic,Overpass,14,18,32,0.4375
Mythic,Vertigo,14,10,24,0.5833333333333334
N2E,Ancient,1,2,3,0.3333333333333333
N2E,Dust2,1,0,1,1.0
N2E,Inferno,0,1,1,0.0
N2E,Mirage,1,1,2,0.5
N2E,Nuke,0,1,1,0.0
NA's Finest,Dust2,1,1,2,0.5
NA's Finest,Inferno,0,1,1,0.0
NA's Finest,Mirage,3,2,5,0.6
NA's Finest,Nuke,2,1,3,0.6666666666666666
NA's Finest,Overpass,1,1,2,0.5
NASA,Ancient,0,1,1,0.0
NASA,Dust2,0,2,2,0.0
NASA,Inferno,2,0,2,1.0
NASA,Mirage,2,0,2,1.0
NASA,Nuke,0,2,2,0.0
NASA,Overpass,1,0,1,1.0
NASR,Ancient,1,2,3,0.3333333333333333
NASR,Dust2,4,6,10,0.4
NASR,Inferno,6,6,12,0.5
NASR,Mirage,8,3,11,0.7272727272727273
NASR,Nuke,5,6,11,0.45454545454545453
NASR,Overpass,0,2,2,0.0
NASR,Vertigo,2,2,4,0.5
NAVI Javelins,Ancient,3,2,5,0.6
NAVI Javelins,Anubis,2,0,2,1.0
NAVI Javelins,Dust2,1,1,2,0.5
NAVI Javelins,Inferno,3,3,6,0.5
NAVI Javelins,Mirage,1,2,3,0.3333333333333333
NAVI Javelins,Nuke,6,1,7,0.8571428571428571
NAVI Javelins,Vertigo,4,4,8,0.5
NAVI Junior,Ancient,4,6,10,0.4
NAVI Junior,Anubis,0,2,2,0.0
NAVI Junior,Dust2,12,8,20,0.6
NAVI Junior,Inferno,10,13,23,0.43478260869565216
NAVI Junior,Mirage,17,14,31,0.5483870967741935
NAVI Junior,Overpass,4,9,13,0.3076923076923077
NAVI Junior,Vertigo,16,17,33,0.48484848484848486
NEO's Team,Inferno,1,0,1,1.0
NEO's Team,Mirage,2,1,3,0.6666666666666666
NEO's Team,Overpass,1,1,2,0.5
NEO's Team,Vertigo,0,1,1,0.0
NEXGA,Dust2,0,1,1,0.0
NEXGA,Inferno,1,3,4,0.25
NEXGA,Mirage,0,1,1,0.0
NEXGA,Nuke,0,2,2,0.0
NIISUN,Inferno,0,1,1,0.0
NIISUN,Mirage,0,1,1,0.0
NIJE,Ancient,0,1,1,0.0
NIJE,Dust2,0,2,2,0.0
NIJE,Mirage,0,1,1,0.0
NIJE,Overpass,2,0,2,1.0
NIP fe,Inferno,1,0,1,1.0
NIP fe,Mirage,1,0,1,1.0
NIP fe,Overpass,1,1,2,0.5
NIP fe,Vertigo,1,1,2,0.5
NKT,Ancient,3,5,8,0.375
NKT,Anubis,0,1,1,0.0
NKT,Dust2,9,9,18,0.5
NKT,Inferno,26,17,43,0.6046511627906976
NKT,Mirage,17,10,27,0.6296296296296297
NKT,Nuke,19,15,34,0.5588235294117647
NKT,Overpass,14,10,24,0.5833333333333334
NKT,Vertigo,7,7,14,0.5
NLG,Ancient,10,8,18,0.5555555555555556
NLG,Dust2,4,9,13,0.3076923076923077
NLG,Inferno,3,6,9,0.3333333333333333
NLG,Mirage,4,8,12,0.3333333333333333
NLG,Nuke,1,0,1,1.0
NLG,Overpass,6,6,12,0.5
NLG,Vertigo,7,6,13,0.5384615384615384
NO NAME,Ancient,0,1,1,0.0
NO NAME,Anubis,1,0,1,1.0
NO NAME,Mirage,2,0,2,1.0
NO NAME,Nuke,1,0,1,1.0
NO NAME,Overpass,0,1,1,0.0
NO NAME,Vertigo,0,1,1,0.0
NO ORG,Nuke,0,1,1,0.0
NOFEAR5,Ancient,0,1,1,0.0
NOFEAR5,Dust2,1,1,2,0.5
NOFEAR5,Inferno,1,0,1,1.0
NOFEAR5,Mirage,1,1,2,0.5
NOFEAR5,Overpass,1,1,2,0.5
NOFEAR5,Vertigo,2,0,2,1.0
NOISEOTREM,Mirage,0,1,1,0.0
NOM,Inferno,1,0,1,1.0
NOM,Mirage,0,4,4,0.0
NOM,Nuke,1,0,1,1.0
NOORG,Ancient,1,1,2,0.5
NOORG,Mirage,1,2,3,0.3333333333333333
NOORG,Nuke,0,1,1,0.0
NOORG,Vertigo,1,0,1,1.0
NSC,Dust2,1,0,1,1.0
NSC,Inferno,1,3,4,0.25
NSC,Nuke,0,2,2,0.0
NSC,Overpass,0,1,1,0.0
NSC,Vertigo,1,2,3,0.3333333333333333
NSN,Ancient,2,1,3,0.6666666666666666
NSN,Dust2,2,0,2,1.0
NSN,Inferno,2,3,5,0.4
NSN,Mirage,0,5,5,0.0
NSN,Nuke,2,2,4,0.5
NSN,Overpass,0,1,1,0.0
NYYRIKKI,Ancient,0,2,2,0.0
NYYRIKKI,Inferno,1,2,3,0.3333333333333333
NYYRIKKI,Mirage,2,0,2,1.0
NYYRIKKI,Nuke,1,4,5,0.2
NYYRIKKI,Overpass,1,1,2,0.5
NYYRIKKI,Vertigo,0,2,2,0.0
Namibia,Inferno,0,1,1,0.0
Namibia,Mirage,0,1,1,0.0
Namibia,Overpass,0,1,1,0.0
Narcis,Ancient,0,1,1,0.0
Narcis,Inferno,1,1,2,0.5
Narcis,Mirage,0,1,1,0.0
Narcis,Overpass,1,0,1,1.0
Narcis,Vertigo,0,1,1,0.0
Natus Vincere,Ancient,19,8,27,0.7037037037037037
Natus Vincere,Anubis,2,0,2,1.0
Natus Vincere,Dust2,27,8,35,0.7714285714285715
Natus Vincere,Inferno,32,22,54,0.5925925925925926
Natus Vincere,Mirage,43,23,66,0.6515151515151515
Natus Vincere,Nuke,32,11,43,0.7441860465116279
Natus Vincere,Overpass,22,13,35,0.6285714285714286
Nebula,Dust2,0,2,2,0.0
Nebula,Inferno,0,1,1,0.0
Nebula,Mirage,1,0,1,1.0
Nebula,Nuke,0,2,2,0.0
Nebula,Overpass,1,1,2,0.5
Nebula,Vertigo,0,3,3,0.0
NeedDOCTOR,Ancient,2,1,3,0.6666666666666666
NeedDOCTOR,Dust2,1,2,3,0.3333333333333333
NeedDOCTOR,Inferno,5,2,7,0.7142857142857143
NeedDOCTOR,Mirage,6,5,11,0.5454545454545454
NeedDOCTOR,Nuke,0,1,1,0.0
NeedDOCTOR,Overpass,2,4,6,0.3333333333333333
Nemesis,Mirage,0,1,1,0.0
Nemiga,Ancient,0,3,3,0.0
Nemiga,Dust2,13,15,28,0.4642857142857143
Nemiga,Inferno,39,34,73,0.5342465753424658
Nemiga,Mirage,24,28,52,0.46153846153846156
Nemiga,Nuke,25,19,44,0.5681818181818182
Nemiga,Overpass,14,21,35,0.4
Nemiga,Vertigo,14,13,27,0.5185185185185185
Neon Rangers,Inferno,0,1,1,0.0
Neon Rangers,Mirage,0,1,1,0.0
Netherlands,Mirage,0,1,1,0.0
Netherlands,Nuke,0,1,1,0.0
Netherlands,Vertigo,1,0,1,1.0
Never Surrender,Ancient,0,2,2,0.0
Never Surrender,Inferno,1,1,2,0.5
Never Surrender,Overpass,0,1,1,0.0
New Pampas,Ancient,1,1,2,0.5
New Pampas,Inferno,0,3,3,0.0
New Pampas,Mirage,1,2,3,0.3333333333333333
New Pampas,Nuke,1,4,5,0.2
New Pampas,Overpass,4,1,5,0.8
New Threat,Ancient,2,3,5,0.4
New Threat,Dust2,1,1,2,0.5
New Threat,Inferno,0,3,3,0.0
New Threat,Mirage,1,4,5,0.2
New Threat,Nuke,0,3,3,0.0
New Threat,Overpass,2,1,3,0.6666666666666666
New Threat,Vertigo,2,3,5,0.4
NewBALLS,Ancient,0,1,1,0.0
NewBALLS,Overpass,0,1,1,0.0
NewBALLS,Vertigo,1,0,1,1.0
NewBelarus,Dust2,2,1,3,0.6666666666666666
NewBelarus,Inferno,2,5,7,0.2857142857142857
NewBelarus,Mirage,0,1,1,0.0
NewBelarus,Nuke,2,1,3,0.6666666666666666
NewBelarus,Overpass,1,2,3,0.3333333333333333
NewBelarus,Vertigo,2,4,6,0.3333333333333333
Newhappy,Ancient,1,1,2,0.5
Newhappy,Anubis,1,0,1,1.0
Newhappy,Dust2,1,3,4,0.25
Newhappy,Inferno,0,4,4,0.0
Newhappy,Mirage,0,1,1,0.0
Newhappy,Nuke,1,2,3,0.3333333333333333
Next in Line,Mirage,0,1,1,0.0
Next in Line,Nuke,0,1,1,0.0
Next in Line,Overpass,0,1,1,0.0
Next in Line,Vertigo,0,1,1,0.0
Nexus,Ancient,20,11,31,0.6451612903225806
Nexus,Anubis,0,4,4,0.0
Nexus,Dust2,29,24,53,0.5471698113207547
Nexus,Inferno,34,30,64,0.53125
Nexus,Mirage,40,31,71,0.5633802816901409
Nexus,Nuke,23,31,54,0.42592592592592593
Nexus,Overpass,3,9,12,0.25
Nexus,Vertigo,11,20,31,0.3548387096774194
Nexus Academy,Ancient,1,0,1,1.0
Nexus Academy,Dust2,0,1,1,0.0
Nexus Academy,Mirage,0,1,1,0.0
Nigma Galaxy,Ancient,4,2,6,0.6666666666666666
Nigma Galaxy,Dust2,2,1,3,0.6666666666666666
Nigma Galaxy,Inferno,6,5,11,0.5454545454545454
Nigma Galaxy,Mirage,2,1,3,0.6666666666666666
Nigma Galaxy,Nuke,2,0,2,1.0
Nigma Galaxy,Overpass,5,2,7,0.7142857142857143
Nigma Galaxy,Vertigo,7,0,7,1.0
Ninjas in Pyjamas,Ancient,24,14,38,0.631578947368421
Ninjas in Pyjamas,Dust2,3,8,11,0.2727272727272727
Ninjas in Pyjamas,Inferno,32,21,53,0.6037735849056604
Ninjas in Pyjamas,Mirage,19,20,39,0.48717948717948717
Ninjas in Pyjamas,Nuke,21,18,39,0.5384615384615384
Ninjas in Pyjamas,Overpass,23,20,43,0.5348837209302325
Ninjas in Pyjamas,Vertigo,14,9,23,0.6086956521739131
Nixuh,Dust2,5,0,5,1.0
Nixuh,Inferno,6,1,7,0.8571428571428571
Nixuh,Mirage,1,2,3,0.3333333333333333
Nixuh,Nuke,3,2,5,0.6
Nixuh,Vertigo,1,2,3,0.3333333333333333
No Org,Ancient,1,0,1,1.0
No Org,Dust2,0,3,3,0.0
No Org,Inferno,0,1,1,0.0
No Org,Mirage,1,2,3,0.3333333333333333
No Org,Nuke,1,1,2,0.5
No Org,Overpass,0,1,1,0.0
No Org,Vertigo,1,0,1,1.0
NoNamers,Dust2,1,0,1,1.0
NoNamers,Overpass,0,1,1,0.0
NoRespect,Ancient,1,0,1,1.0
NoVa's Birthday Brawlers,Inferno,1,0,1,1.0
NoVa's Birthday Brawlers,Nuke,0,1,1,0.0
NoVa's Birthday Brawlers,Vertigo,0,1,1,0.0
Nocturns,Inferno,2,2,4,0.5
Nocturns,Mirage,0,5,5,0.0
Nocturns,Nuke,1,3,4,0.25
Nocturns,Overpass,1,3,4,0.25
NorVa's Last Peek,Ancient,0,1,1,0.0
NorVa's Last Peek,Mirage,0,1,1,0.0
Nordavind,Dust2,0,1,1,0.0
Nordavind,Inferno,0,1,1,0.0
Nordavind,Mirage,1,2,3,0.3333333333333333
Nordavind,Nuke,1,0,1,1.0
Nordavind,Vertigo,0,2,2,0.0
Northern Forces,Ancient,0,2,2,0.0
Northern Forces,Dust2,0,1,1,0.0
Northern Forces,Inferno,8,8,16,0.5
Northern Forces,Mirage,10,9,19,0.5263157894736842
Northern Forces,Nuke,8,12,20,0.4
Northern Forces,Overpass,2,10,12,0.16666666666666666
Northern Forces,Vertigo,2,4,6,0.3333333333333333
Northwest,Ancient,0,1,1,0.0
Northwest,Mirage,1,0,1,1.0
Northwest,Vertigo,0,1,1,0.0
Norway,Inferno,0,1,1,0.0
Norway,Mirage,3,1,4,0.75
Norway,Nuke,1,2,3,0.3333333333333333
Norway,Overpass,1,0,1,1.0
Norway,Vertigo,0,1,1,0.0
Nouns,Ancient,4,5,9,0.4444444444444444
Nouns,Anubis,2,0,2,1.0
Nouns,Dust2,2,1,3,0.6666666666666666
Nouns,Inferno,24,12,36,0.6666666666666666
Nouns,Mirage,17,10,27,0.6296296296296297
Nouns,Nuke,4,5,9,0.4444444444444444
Nouns,Overpass,11,11,22,0.5
Nouns,Vertigo,9,9,18,0.5
Now you know,Inferno,0,1,1,0.0
Noxious,Ancient,1,1,2,0.5
Noxious,Inferno,0,2,2,0.0
Noxious,Mirage,4,4,8,0.5
Noxious,Nuke,0,2,2,0.0
Noxious,Overpass,0,5,5,0.0
Noxious,Vertigo,1,3,4,0.25
NtK,Ancient,0,1,1,0.0
NtK,Inferno,1,2,3,0.3333333333333333
NtK,Mirage,2,1,3,0.6666666666666666
NtK,Nuke,1,0,1,1.0
NtK,Overpass,0,1,1,0.0
NtK,Vertigo,0,1,1,0.0
Nut-E,Ancient,1,3,4,0.25
Nut-E,Dust2,9,3,12,0.75
Nut-E,Inferno,5,8,13,0.38461538461538464
Nut-E,Mirage,5,9,14,0.35714285714285715
Nut-E,Overpass,0,3,3,0.0
Nut-E,Vertigo,2,4,6,0.3333333333333333
NwG,Mirage,0,1,1,0.0
NwG,Nuke,0,1,1,0.0
O PLANO,Ancient,0,1,1,0.0
O PLANO,Anubis,0,3,3,0.0
O PLANO,Dust2,5,6,11,0.45454545454545453
O PLANO,Inferno,8,6,14,0.5714285714285714
O PLANO,Mirage,8,9,17,0.47058823529411764
O PLANO,Nuke,13,7,20,0.65
O PLANO,Overpass,5,7,12,0.4166666666666667
O PLANO,Vertigo,5,9,14,0.35714285714285715
ODDIK,Ancient,14,6,20,0.7
ODDIK,Anubis,3,4,7,0.42857142857142855
ODDIK,Dust2,12,9,21,0.5714285714285714
ODDIK,Inferno,6,6,12,0.5
ODDIK,Mirage,6,7,13,0.46153846153846156
ODDIK,Nuke,16,10,26,0.6153846153846154
ODDIK,Overpass,3,9,12,0.25
OFFSET,Ancient,4,8,12,0.3333333333333333
OFFSET,Dust2,2,6,8,0.25
OFFSET,Inferno,12,16,28,0.42857142857142855
OFFSET,Mirage,5,5,10,0.5
OFFSET,Nuke,11,13,24,0.4583333333333333
OFFSET,Overpass,3,7,10,0.3
OFFSET,Vertigo,7,8,15,0.4666666666666667
OG,Ancient,20,11,31,0.6451612903225806
OG,Anubis,2,1,3,0.6666666666666666
OG,Dust2,13,8,21,0.6190476190476191
OG,Inferno,24,17,41,0.5853658536585366
OG,Mirage,22,26,48,0.4583333333333333
OG,Nuke,3,7,10,0.3
OG,Overpass,14,12,26,0.5384615384615384
OG,Vertigo,5,6,11,0.45454545454545453
OG Academy,Ancient,3,6,9,0.3333333333333333
OG Academy,Dust2,10,3,13,0.7692307692307693
OG Academy,Inferno,9,12,21,0.42857142857142855
OG Academy,Mirage,3,5,8,0.375
OG Academy,Nuke,1,1,2,0.5
OG Academy,Overpass,7,8,15,0.4666666666666667
OG Academy,Vertigo,3,3,6,0.5
ONET4P,Ancient,2,6,8,0.25
ONET4P,Dust2,5,13,18,0.2777777777777778
ONET4P,Inferno,14,17,31,0.45161290322580644
ONET4P,Mirage,7,11,18,0.3888888888888889
ONET4P,Nuke,6,11,17,0.35294117647058826
ONET4P,Overpass,3,1,4,0.75
ONET4P,Vertigo,7,7,14,0.5
ONYX,Ancient,8,6,14,0.5714285714285714
ONYX,Dust2,4,3,7,0.5714285714285714
ONYX,Inferno,13,15,28,0.4642857142857143
ONYX,Mirage,9,14,23,0.391304347826087
ONYX,Nuke,7,15,22,0.3181818181818182
ONYX,Overpass,7,4,11,0.6363636363636364
ONYX,Vertigo,5,7,12,0.4166666666666667
ONYX Talents,Ancient,0,1,1,0.0
ONYX Talents,Dust2,0,2,2,0.0
ONYX Talents,Inferno,2,1,3,0.6666666666666666
ONYX Talents,Overpass,0,1,1,0.0
ONYX Talents,Vertigo,0,2,2,0.0
OPAA,Ancient,6,5,11,0.5454545454545454
OPAA,Dust2,0,3,3,0.0
OPAA,Inferno,6,5,11,0.5454545454545454
OPAA,Mirage,0,1,1,0.0
OPAA,Nuke,7,6,13,0.5384615384615384
OPAA,Overpass,5,5,10,0.5
OPAA,Vertigo,6,8,14,0.42857142857142855
ORDER,Ancient,10,7,17,0.5882352941176471
ORDER,Dust2,15,10,25,0.6
ORDER,Inferno,5,0,5,1.0
ORDER,Mirage,19,11,30,0.6333333333333333
ORDER,Nuke,19,18,37,0.5135135135135135
ORDER,Overpass,12,4,16,0.75
ORDER,Vertigo,16,11,27,0.5925925925925926
ORGLESS fe,Nuke,0,1,1,0.0
ORGLESS fe,Overpass,0,1,1,0.0
ORO,Ancient,0,1,1,0.0
ORO,Inferno,1,0,1,1.0
ORO,Nuke,1,0,1,1.0
OS,Ancient,0,1,1,0.0
OS,Inferno,0,2,2,0.0
OS,Vertigo,0,1,1,0.0
OUTPLAYED,Ancient,0,1,1,0.0
OUTPLAYED,Inferno,0,1,1,0.0
OUTPLAYED,Nuke,0,1,1,0.0
OUTPLAYED,Overpass,0,1,1,0.0
Oilers,Ancient,2,2,4,0.5
Oilers,Dust2,1,3,4,0.25
Oilers,Inferno,3,1,4,0.75
Oilers,Mirage,3,1,4,0.75
Oilers,Nuke,2,3,5,0.4
Oilers,Overpass,3,5,8,0.375
Oilers,Vertigo,1,0,1,1.0
Old But Gold,Ancient,1,0,1,1.0
Old But Gold,Dust2,1,1,2,0.5
Old But Gold,Inferno,1,1,2,0.5
Old But Gold,Mirage,0,2,2,0.0
Old But Gold,Vertigo,0,1,1,0.0
Omapeli,Ancient,1,0,1,1.0
Omapeli,Dust2,1,1,2,0.5
Omapeli,Inferno,2,1,3,0.6666666666666666
Omapeli,Nuke,2,3,5,0.4
Omapeli,Overpass,2,0,2,1.0
Omapeli,Vertigo,0,1,1,0.0
Omega,Ancient,0,3,3,0.0
Omega,Dust2,0,1,1,0.0
Omega,Inferno,1,2,3,0.3333333333333333
Omega,Mirage,2,5,7,0.2857142857142857
Omega,Overpass,2,0,2,1.0
Omega,Vertigo,1,3,4,0.25
One More Time,Overpass,0,1,1,0.0
One Shot,Tuscan,0,1,1,0.0
OneTap,Ancient,0,2,2,0.0
OneTap,Dust2,11,4,15,0.7333333333333333
OneTap,Inferno,4,14,18,0.2222222222222222
OneTap,Mirage,19,15,34,0.5588235294117647
OneTap,Nuke,6,13,19,0.3157894736842105
OneTap,Overpass,13,8,21,0.6190476190476191
OneTap,Vertigo,9,3,12,0.75
OnlineBOTS,Dust2,0,1,1,0.0
OnlineBOTS,Inferno,1,1,2,0.5
OnlineBOTS,Mirage,0,3,3,0.0
OnlineBOTS,Overpass,0,1,1,0.0
Only One Word,Ancient,0,1,1,0.0
Only One Word,Dust2,1,0,1,1.0
Only One Word,Mirage,0,1,1,0.0
Only One Word,Nuke,0,1,1,0.0
Only One Word,Vertigo,1,0,1,1.0
Ooredoo Thunders,Ancient,1,0,1,1.0
Ooredoo Thunders,Anubis,0,1,1,0.0
Ooredoo Thunders,Inferno,2,3,5,0.4
Ooredoo Thunders,Mirage,1,0,1,1.0
Ooredoo Thunders,Overpass,1,1,2,0.5
Ooredoo Thunders,Vertigo,0,1,1,0.0
Operation Save Spot,Inferno,0,1,1,0.0
Operation Save Spot,Nuke,0,1,1,0.0
Orgless,Ancient,3,2,5,0.6
Orgless,Dust2,4,3,7,0.5714285714285714
Orgless,Inferno,3,4,7,0.42857142857142855
Orgless,Mirage,2,1,3,0.6666666666666666
Orgless,Nuke,0,2,2,0.0
Orgless,Overpass,5,4,9,0.5555555555555556
Orgless,Vertigo,1,3,4,0.25
Orgless Heroes,Ancient,1,0,1,1.0
Orgless Heroes,Anubis,1,0,1,1.0
Orgless Heroes,Inferno,2,0,2,1.0
Orgless Heroes,Mirage,2,0,2,1.0
Orgless Heroes,Vertigo,2,0,2,1.0
Orion,Ancient,1,1,2,0.5
Orion,Inferno,2,5,7,0.2857142857142857
Orion,Mirage,4,3,7,0.5714285714285714
Orion,Nuke,2,3,5,0.4
Orion,Overpass,0,1,1,0.0
Orion's Day Care,Inferno,0,1,1,0.0
Orion's Day Care,Mirage,1,0,1,1.0
Orion's Day Care,Overpass,1,1,2,0.5
Orion's Day Care,Vertigo,1,0,1,1.0
OtherSide,Ancient,0,1,1,0.0
OtherSide,Inferno,0,1,1,0.0
OtherSide,Mirage,0,2,2,0.0
Outsiders,Ancient,5,5,10,0.5
Outsiders,Anubis,1,1,2,0.5
Outsiders,Dust2,16,9,25,0.64
Outsiders,Inferno,24,15,39,0.6153846153846154
Outsiders,Mirage,12,9,21,0.5714285714285714
Outsiders,Overpass,10,7,17,0.5882352941176471
Outsiders,Vertigo,9,9,18,0.5
Outsiders23,Mirage,0,1,1,0.0
Outsiders23,Vertigo,1,0,1,1.0
Overt,Ancient,2,0,2,1.0
Overt,Inferno,2,2,4,0.5
Overt,Mirage,1,3,4,0.25
Overt,Nuke,4,4,8,0.5
Overt,Overpass,1,3,4,0.25
Overt,Vertigo,0,3,3,0.0
Ovoshi,Inferno,1,0,1,1.0
Ovoshi,Mirage,1,1,2,0.5
Ovoshi,Nuke,3,0,3,1.0
Ovoshi,Vertigo,1,0,1,1.0
Ozone,Ancient,0,1,1,0.0
Ozone,Dust2,0,1,1,0.0
Ozone,Nuke,0,1,1,0.0
P2N,Mirage,1,0,1,1.0
P2N,Nuke,0,1,1,0.0
P2N,Vertigo,0,1,1,0.0
PACT,Ancient,16,16,32,0.5
PACT,Dust2,6,22,28,0.21428571428571427
PACT,Inferno,17,18,35,0.4857142857142857
PACT,Mirage,2,1,3,0.6666666666666666
PACT,Nuke,27,24,51,0.5294117647058824
PACT,Overpass,12,20,32,0.375
PACT,Vertigo,23,14,37,0.6216216216216216
PALOMA,Ancient,6,4,10,0.6
PALOMA,Dust2,0,1,1,0.0
PALOMA,Inferno,8,2,10,0.8
PALOMA,Mirage,5,0,5,1.0
PALOMA,Nuke,7,7,14,0.5
PALOMA,Overpass,2,0,2,1.0
PALOMA,Vertigo,2,1,3,0.6666666666666666
PAMPAS,Ancient,0,1,1,0.0
PAMPAS,Inferno,1,0,1,1.0
PAMPAS,Mirage,1,0,1,1.0
PAMPAS,Nuke,3,1,4,0.75
PAMPAS,Overpass,0,2,2,0.0
PAMPAS,Vertigo,0,1,1,0.0
PG,Inferno,0,1,1,0.0
PG,Mirage,1,0,1,1.0
PG,Nuke,0,1,1,0.0
PG,Overpass,1,0,1,1.0
PG,Vertigo,0,1,1,0.0
PGE Turow,Ancient,0,10,10,0.0
PGE Turow,Anubis,0,2,2,0.0
PGE Turow,Inferno,4,4,8,0.5
PGE Turow,Mirage,0,2,2,0.0
PGE Turow,Nuke,5,4,9,0.5555555555555556
PGE Turow,Overpass,1,1,2,0.5
PGE Turow,Vertigo,5,5,10,0.5
PIGNOUF,Ancient,1,0,1,1.0
PIGNOUF,Dust2,0,1,1,0.0
PIGNOUF,Inferno,2,0,2,1.0
PIGNOUF,Nuke,1,0,1,1.0
PIGNOUF,Overpass,0,1,1,0.0
PIVNOE PUZO,Inferno,0,1,1,0.0
PIVNOE PUZO,Vertigo,0,1,1,0.0
PLATOON Beta,Mirage,0,1,1,0.0
PLATOON Beta,Nuke,0,1,1,0.0
PLATOON Beta,Vertigo,1,0,1,1.0
POGGERZ,Dust2,1,2,3,0.3333333333333333
POGGERZ,Inferno,2,1,3,0.6666666666666666
POGGERZ,Mirage,2,3,5,0.4
POGGERZ,Nuke,0,1,1,0.0
POGGERZ,Vertigo,2,0,2,1.0
POLET,Dust2,0,2,2,0.0
POLET,Inferno,2,1,3,0.6666666666666666
POLET,Mirage,0,2,2,0.0
POLET,Nuke,2,2,4,0.5
POLET,Overpass,0,1,1,0.0
POLIGON,Dust2,0,1,1,0.0
PORTUGAL,Dust2,2,0,2,1.0
PORTUGAL,Inferno,0,2,2,0.0
PORTUGAL,Mirage,3,1,4,0.75
PORTUGAL,Nuke,0,1,1,0.0
PPP,Dust2,0,1,1,0.0
PPP,Overpass,0,1,1,0.0
PR Stars,Ancient,1,1,2,0.5
PR Stars,Dust2,1,2,3,0.3333333333333333
PR Stars,Inferno,0,1,1,0.0
PR Stars,Mirage,0,1,1,0.0
PR Stars,Nuke,2,1,3,0.6666666666666666
PR Stars,Overpass,0,1,1,0.0
PROSPECTS,Ancient,23,16,39,0.5897435897435898
PROSPECTS,Anubis,0,1,1,0.0
PROSPECTS,Dust2,7,6,13,0.5384615384615384
PROSPECTS,Inferno,16,22,38,0.42105263157894735
PROSPECTS,Mirage,17,16,33,0.5151515151515151
PROSPECTS,Nuke,8,14,22,0.36363636363636365
PROSPECTS,Overpass,32,30,62,0.5161290322580645
PROSPECTS,Vertigo,13,12,25,0.52
Panthers,Ancient,1,0,1,1.0
Panthers,Inferno,0,1,1,0.0
Panthers,Nuke,0,1,1,0.0
PaquetГЎ,Ancient,8,6,14,0.5714285714285714
PaquetГЎ,Anubis,1,1,2,0.5
PaquetГЎ,Dust2,17,15,32,0.53125
PaquetГЎ,Inferno,8,7,15,0.5333333333333333
PaquetГЎ,Mirage,21,13,34,0.6176470588235294
PaquetГЎ,Nuke,19,19,38,0.5
PaquetГЎ,Overpass,23,11,34,0.6764705882352942
PaquetГЎ,Vertigo,16,4,20,0.8
Paradox,Ancient,2,1,3,0.6666666666666666
Paradox,Dust2,11,6,17,0.6470588235294118
Paradox,Inferno,8,4,12,0.6666666666666666
Paradox,Mirage,12,4,16,0.75
Paradox,Nuke,15,12,27,0.5555555555555556
Paradox,Overpass,6,6,12,0.5
Paradox,Vertigo,3,9,12,0.25
ParisDemons,Ancient,1,1,2,0.5
ParisDemons,Anubis,1,0,1,1.0
ParisDemons,Inferno,1,1,2,0.5
ParisDemons,Mirage,0,1,1,0.0
ParisDemons,Nuke,1,2,3,0.3333333333333333
Partizan,Ancient,8,8,16,0.5
Partizan,Anubis,5,5,10,0.5
Partizan,Dust2,7,6,13,0.5384615384615384
Partizan,Inferno,15,10,25,0.6
Partizan,Mirage,10,10,20,0.5
Partizan,Nuke,8,3,11,0.7272727272727273
Partizan,Vertigo,11,9,20,0.55
Party Astronauts,Ancient,7,10,17,0.4117647058823529
Party Astronauts,Dust2,17,8,25,0.68
Party Astronauts,Inferno,49,25,74,0.6621621621621622
Party Astronauts,Mirage,30,14,44,0.6818181818181818
Party Astronauts,Nuke,42,23,65,0.6461538461538462
Party Astronauts,Overpass,28,18,46,0.6086956521739131
Party Daddlers,Inferno,2,0,2,1.0
Party Daddlers,Mirage,0,2,2,0.0
Party Daddlers,Overpass,1,0,1,1.0
Patins da Ferrari,Dust2,0,3,3,0.0
Patins da Ferrari,Inferno,3,0,3,1.0
Patins da Ferrari,Mirage,1,2,3,0.3333333333333333
Patins da Ferrari,Nuke,1,1,2,0.5
Patins da Ferrari,Overpass,0,1,1,0.0
Patins da Ferrari,Vertigo,0,1,1,0.0
Paying Myself,Inferno,1,0,1,1.0
Paying Myself,Mirage,1,1,2,0.5
Paying Myself,Vertigo,0,1,1,0.0
Peace Ducks,Inferno,0,1,1,0.0
Peace Ducks,Nuke,0,1,1,0.0
Peace of Heroes,Ancient,1,0,1,1.0
Peace of Heroes,Dust2,0,1,1,0.0
Peace of Heroes,Inferno,0,1,1,0.0
Peace of Heroes,Vertigo,0,2,2,0.0
PeakyBlinders,Ancient,1,0,1,1.0
PeakyBlinders,Mirage,0,1,1,0.0
PeakyBlinders,Overpass,0,1,1,0.0
Peeker's Advantage,Dust2,0,1,1,0.0
Peekers,Ancient,1,0,1,1.0
Peekers,Inferno,0,1,1,0.0
Peekers,Vertigo,0,1,1,0.0
Pepsilon,Ancient,0,1,1,0.0
Pepsilon,Anubis,0,2,2,0.0
Pepsilon,Mirage,2,1,3,0.6666666666666666
Pepsilon,Overpass,0,1,1,0.0
Pepsilon,Vertigo,0,1,1,0.0
Permitta,Ancient,7,4,11,0.6363636363636364
Permitta,Inferno,3,1,4,0.75
Permitta,Mirage,7,4,11,0.6363636363636364
Permitta,Nuke,8,6,14,0.5714285714285714
Permitta,Overpass,2,6,8,0.25
Permitta,Vertigo,3,7,10,0.3
Perspektiva,Ancient,0,1,1,0.0
Perspektiva,Inferno,0,2,2,0.0
Perspektiva,Mirage,0,2,2,0.0
Pete's Hookah Lounge,Dust2,0,1,1,0.0
Pete's Hookah Lounge,Inferno,1,0,1,1.0
Pete's Hookah Lounge,Nuke,1,0,1,1.0
Pete's Hookah Lounge,Overpass,0,1,1,0.0
Phantom Troupe,Ancient,1,0,1,1.0
Phantom Troupe,Dust2,0,2,2,0.0
Phantom Troupe,Inferno,1,2,3,0.3333333333333333
Phantom Troupe,Mirage,1,3,4,0.25
Phantom Troupe,Nuke,2,3,5,0.4
Phantom Troupe,Overpass,1,2,3,0.3333333333333333
Phantom Troupe,Vertigo,0,1,1,0.0
Pharnap,Dust2,1,1,2,0.5
Pharnap,Inferno,1,0,1,1.0
Pharnap,Mirage,4,0,4,1.0
Pharnap,Nuke,0,1,1,0.0
Philadelphia Liberty,Dust2,1,1,2,0.5
Philadelphia Liberty,Inferno,3,4,7,0.42857142857142855
Philadelphia Liberty,Mirage,2,4,6,0.3333333333333333
Philadelphia Liberty,Nuke,3,2,5,0.6
Philadelphia Liberty,Overpass,1,0,1,1.0
Philadelphia Liberty,Vertigo,1,3,4,0.25
PisoDeMadera,Inferno,1,0,1,1.0
PisoDeMadera,Mirage,0,1,1,0.0
PisoDeMadera,Nuke,0,1,1,0.0
Planet Express,Dust2,0,1,1,0.0
Planet Express,Inferno,0,2,2,0.0
Planet Express,Mirage,0,1,1,0.0
Platinum Blonde,Dust2,0,1,1,0.0
Platinum Blonde,Inferno,2,1,3,0.6666666666666666
Platinum Blonde,Nuke,1,0,1,1.0
Platinum Blonde,Vertigo,1,1,2,0.5
Players,Ancient,3,1,4,0.75
Players,Dust2,1,2,3,0.3333333333333333
Players,Inferno,3,2,5,0.6
Players,Mirage,3,0,3,1.0
Players,Nuke,0,2,2,0.0
Players,Overpass,3,4,7,0.42857142857142855
Players,Vertigo,1,0,1,1.0
Please Send Bocks,Dust2,0,1,1,0.0
Please Send Bocks,Mirage,1,0,1,1.0
Please Send Bocks,Overpass,1,0,1,1.0
Please Send Bocks,Vertigo,0,1,1,0.0
Please Send Help,Inferno,1,5,6,0.16666666666666666
Please Send Help,Mirage,1,3,4,0.25
Please Send Help,Nuke,1,1,2,0.5
Please Send Help,Overpass,1,5,6,0.16666666666666666
PoP,Dust2,2,1,3,0.6666666666666666
PoP,Inferno,2,2,4,0.5
PoP,Mirage,2,5,7,0.2857142857142857
PoP,Vertigo,2,5,7,0.2857142857142857
Portugal,Dust2,1,1,2,0.5
Portugal,Inferno,1,0,1,1.0
Portugal,Mirage,0,1,1,0.0
Portuguese Family,Ancient,2,0,2,1.0
Portuguese Family,Dust2,0,1,1,0.0
Portuguese Family,Inferno,1,1,2,0.5
Portuguese Family,Mirage,0,1,1,0.0
Portuguese Family,Vertigo,0,1,1,0.0
Post Mortem,Ancient,1,3,4,0.25
Post Mortem,Inferno,1,1,2,0.5
Post Mortem,Mirage,1,6,7,0.14285714285714285
Post Mortem,Nuke,1,0,1,1.0
Post Mortem,Overpass,1,1,2,0.5
Post Mortem,Vertigo,0,1,1,0.0
PremuimGods,Mirage,1,1,2,0.5
PremuimGods,Nuke,0,1,1,0.0
Prison Break,Ancient,0,1,1,0.0
Prison Break,Dust2,1,0,1,1.0
Prison Break,Inferno,0,1,1,0.0
Prison Break,Mirage,4,1,5,0.8
Prison Break,Nuke,2,2,4,0.5
Prison Break,Overpass,0,1,1,0.0
Prison Break,Vertigo,1,0,1,1.0
Problematic Kings,Inferno,0,1,1,0.0
Problematic Kings,Overpass,0,1,1,0.0
Procivitas Vaxjo,Overpass,0,1,1,0.0
Procivitas Vaxjo,Vertigo,0,1,1,0.0
Prodigy,Ancient,2,0,2,1.0
Prodigy,Inferno,0,1,1,0.0
Prodigy,Vertigo,1,0,1,1.0
Project Eversio,Ancient,0,1,1,0.0
Project Eversio,Mirage,3,2,5,0.6
Project Eversio,Nuke,2,1,3,0.6666666666666666
Project Eversio,Overpass,1,1,2,0.5
Project Eversio,Vertigo,0,4,4,0.0
Prosapia,Inferno,0,1,1,0.0
Prosapia,Nuke,0,2,2,0.0
Prosapia,Overpass,0,3,3,0.0
Prosapia,Vertigo,1,1,2,0.5
Protos,Dust2,1,0,1,1.0
Protos,Inferno,0,1,1,0.0
Protos,Mirage,1,0,1,1.0
Pryde,Dust2,1,1,2,0.5
Pryde,Inferno,0,1,1,0.0
Pryde,Mirage,0,1,1,0.0
Pryde,Nuke,1,1,2,0.5
Pryde,Vertigo,1,1,2,0.5
Pugbots,Dust2,1,0,1,1.0
Pugbots,Inferno,0,1,1,0.0
Pugbots,Mirage,1,1,2,0.5
Pugbots,Overpass,0,2,2,0.0
Pugbots,Vertigo,1,0,1,1.0
Puggers Not Poggers,Mirage,0,1,1,0.0
Puggers Not Poggers,Overpass,0,1,1,0.0
Puggers Not Poggers,Vertigo,0,1,1,0.0
Pusheens,Dust2,0,1,1,0.0
Pyhan Ilona,Inferno,0,1,1,0.0
Pyhan Ilona,Nuke,0,1,1,0.0
QUAZAR,Ancient,3,7,10,0.3
QUAZAR,Anubis,1,0,1,1.0
QUAZAR,Dust2,1,3,4,0.25
QUAZAR,Mirage,3,2,5,0.6
QUAZAR,Nuke,0,4,4,0.0
QUAZAR,Overpass,2,2,4,0.5
QUAZAR,Vertigo,1,0,1,1.0
QcClan,Mirage,0,1,1,0.0
QcClan,Nuke,0,1,1,0.0
Quantum Bellator Fire,Dust2,1,0,1,1.0
Quantum Bellator Fire,Inferno,0,1,1,0.0
Quantum Bellator Fire,Train,0,1,1,0.0
Quantum Prodigy,Ancient,0,1,1,0.0
Quantum Prodigy,Dust2,1,1,2,0.5
Quantum Prodigy,Inferno,1,1,2,0.5
Quantum Prodigy,Mirage,0,1,1,0.0
Quantum Prodigy,Nuke,2,0,2,1.0
Quantum Prodigy,Overpass,3,1,4,0.75
Quantum Prodigy,Vertigo,1,2,3,0.3333333333333333
Quem Sao Elas,Dust2,0,1,1,0.0
Quem Sao Elas,Inferno,0,1,1,0.0
Quem Sao Elas,Mirage,1,3,4,0.25
Quem Sao Elas,Nuke,0,2,2,0.0
Quem Sao Elas,Vertigo,0,1,1,0.0
Question Mark,Inferno,0,1,1,0.0
Question Mark,Vertigo,0,1,1,0.0
Question Mark!,Vertigo,0,1,1,0.0
RATIO'D,Ancient,0,1,1,0.0
RATIO'D,Nuke,0,1,1,0.0
RBG,Dust2,5,9,14,0.35714285714285715
RBG,Inferno,19,13,32,0.59375
RBG,Mirage,16,13,29,0.5517241379310345
RBG,Nuke,11,20,31,0.3548387096774194
RBG,Overpass,25,14,39,0.6410256410256411
RBG,Vertigo,7,11,18,0.3888888888888889
RCL,Ancient,4,5,9,0.4444444444444444
RCL,Dust2,1,2,3,0.3333333333333333
RCL,Inferno,0,2,2,0.0
RCL,Mirage,3,2,5,0.6
RCL,Nuke,0,2,2,0.0
RCL,Overpass,1,1,2,0.5
RCL,Vertigo,2,1,3,0.6666666666666666
RED Canids,Ancient,1,1,2,0.5
RED Canids,Anubis,3,3,6,0.5
RED Canids,Inferno,3,2,5,0.6
RED Canids,Mirage,2,2,4,0.5
RED Canids,Nuke,2,3,5,0.4
RED Canids,Overpass,0,1,1,0.0
REIGN,Ancient,2,2,4,0.5
REIGN,Anubis,0,1,1,0.0
REIGN,Dust2,2,2,4,0.5
REIGN,Inferno,5,7,12,0.4166666666666667
REIGN,Mirage,2,5,7,0.2857142857142857
REIGN,Nuke,7,8,15,0.4666666666666667
REIGN,Overpass,1,4,5,0.2
REPRESENT,Dust2,0,1,1,0.0
REPRESENT,Nuke,0,1,1,0.0
REZIST,Ancient,2,1,3,0.6666666666666666
REZIST,Dust2,0,2,2,0.0
REZIST,Inferno,5,1,6,0.8333333333333334
REZIST,Mirage,1,2,3,0.3333333333333333
REZIST,Overpass,3,1,4,0.75
REZIST,Vertigo,1,3,4,0.25
RIP Kobe,Mirage,0,1,1,0.0
RIP Kobe,Nuke,1,0,1,1.0
ROYALS,Ancient,1,1,2,0.5
ROYALS,Anubis,0,1,1,0.0
ROYALS,Dust2,2,4,6,0.3333333333333333
ROYALS,Inferno,4,4,8,0.5
ROYALS,Mirage,4,3,7,0.5714285714285714
ROYALS,Nuke,1,7,8,0.125
ROYALS,Overpass,1,7,8,0.125
ROYALS,Vertigo,2,1,3,0.6666666666666666
RUST,Inferno,2,0,2,1.0
RUST,Mirage,1,0,1,1.0
RUST,Overpass,3,0,3,1.0
RUST,Vertigo,0,1,1,0.0
RVNS,Ancient,0,1,1,0.0
RVNS,Dust2,1,0,1,1.0
RVNS,Inferno,0,1,1,0.0
RVNS,Nuke,1,1,2,0.5
RVNS,Overpass,0,1,1,0.0
RWC,Ancient,1,0,1,1.0
RWC,Dust2,0,1,1,0.0
RWC,Mirage,1,1,2,0.5
RWC,Nuke,0,1,1,0.0
RWC,Vertigo,0,1,1,0.0
Racing Avellaneda,Dust2,1,1,2,0.5
Racing Avellaneda,Inferno,0,1,1,0.0
Racing Avellaneda,Mirage,0,1,1,0.0
Racing Avellaneda,Nuke,0,1,1,0.0
Rapid Ninjas,Ancient,0,1,1,0.0
Rapid Ninjas,Inferno,2,1,3,0.6666666666666666
Rapid Ninjas,Mirage,2,2,4,0.5
Rapid Ninjas,Nuke,2,0,2,1.0
Rapid Ninjas,Overpass,0,1,1,0.0
Rare Atom,Ancient,6,7,13,0.46153846153846156
Rare Atom,Anubis,2,1,3,0.6666666666666666
Rare Atom,Inferno,24,11,35,0.6857142857142857
Rare Atom,Mirage,12,5,17,0.7058823529411765
Rare Atom,Nuke,15,6,21,0.7142857142857143
Rare Atom,Overpass,14,4,18,0.7777777777777778
Rare Atom,Vertigo,6,6,12,0.5
Recognised Talent,Inferno,0,1,1,0.0
Recognised Talent,Mirage,0,1,1,0.0
Recon 5,Dust2,0,2,2,0.0
Recon 5,Inferno,3,2,5,0.6
Recon 5,Mirage,2,4,6,0.3333333333333333
Recon 5,Nuke,0,2,2,0.0
Recon 5,Overpass,1,2,3,0.3333333333333333
Recon 5,Vertigo,1,0,1,1.0
Rectify,Ancient,0,2,2,0.0
Rectify,Inferno,0,1,1,0.0
Rectify,Mirage,0,2,2,0.0
Rectify,Nuke,0,1,1,0.0
Rectify,Overpass,1,0,1,1.0
Red,Inferno,1,1,2,0.5
Red,Mirage,0,1,1,0.0
Red,Nuke,0,1,1,0.0
Red,Overpass,0,1,1,0.0
Red Wolves,Ancient,4,9,13,0.3076923076923077
Red Wolves,Dust2,3,5,8,0.375
Red Wolves,Inferno,4,8,12,0.3333333333333333
Red Wolves,Mirage,7,8,15,0.4666666666666667
Red Wolves,Nuke,3,9,12,0.25
Red Wolves,Overpass,1,2,3,0.3333333333333333
Red Wolves,Vertigo,4,2,6,0.6666666666666666
RedPack,Ancient,0,1,1,0.0
RedPack,Anubis,0,1,1,0.0
RedPack,Inferno,1,0,1,1.0
RedPack,Mirage,0,1,1,0.0
RedPack,Vertigo,0,2,2,0.0
Redragon,Ancient,0,3,3,0.0
Redragon,Dust2,15,14,29,0.5172413793103449
Redragon,Inferno,9,8,17,0.5294117647058824
Redragon,Mirage,3,11,14,0.21428571428571427
Redragon,Nuke,3,7,10,0.3
Redragon,Overpass,8,13,21,0.38095238095238093
Redragon,Vertigo,5,6,11,0.45454545454545453
Rehl,Ancient,1,2,3,0.3333333333333333
Rehl,Dust2,6,7,13,0.46153846153846156
Rehl,Inferno,3,10,13,0.23076923076923078
Rehl,Mirage,5,8,13,0.38461538461538464
Rehl,Nuke,1,2,3,0.3333333333333333
Rehl,Overpass,6,7,13,0.46153846153846156
Rehl,Vertigo,0,4,4,0.0
Renegades,Ancient,3,1,4,0.75
Renegades,Dust2,7,4,11,0.6363636363636364
Renegades,Inferno,11,7,18,0.6111111111111112
Renegades,Mirage,10,2,12,0.8333333333333334
Renegades,Nuke,12,7,19,0.631578947368421
Renegades,Overpass,1,1,2,0.5
Renegades,Vertigo,12,4,16,0.75
Renewal,Ancient,2,8,10,0.2
Renewal,Anubis,1,1,2,0.5
Renewal,Dust2,8,4,12,0.6666666666666666
Renewal,Inferno,12,12,24,0.5
Renewal,Mirage,6,8,14,0.42857142857142855
Renewal,Nuke,8,11,19,0.42105263157894735
Renewal,Overpass,4,6,10,0.4
Renewal,Vertigo,0,1,1,0.0
Revel,Dust2,0,2,2,0.0
Revel,Inferno,0,1,1,0.0
Revel,Mirage,0,1,1,0.0
Revel,Overpass,0,2,2,0.0
Revel,Vertigo,0,1,1,0.0
Revelacoes do Ano,Dust2,0,1,1,0.0
Revelacoes do Ano,Inferno,1,0,1,1.0
Revelacoes do Ano,Mirage,1,2,3,0.3333333333333333
Revenge Tour,Inferno,0,1,1,0.0
Rhyno,Ancient,2,0,2,1.0
Rhyno,Dust2,1,0,1,1.0
Rhyno,Nuke,0,3,3,0.0
River Plate,Ancient,6,6,12,0.5
River Plate,Dust2,11,12,23,0.4782608695652174
River Plate,Inferno,17,13,30,0.5666666666666667
River Plate,Mirage,3,1,4,0.75
River Plate,Nuke,13,11,24,0.5416666666666666
River Plate,Overpass,7,9,16,0.4375
River Plate,Vertigo,3,3,6,0.5
Rombus,Ancient,0,1,1,0.0
Rombus,Inferno,0,1,1,0.0
Rooster,Ancient,0,1,1,0.0
Rooster,Anubis,1,0,1,1.0
Rooster,Dust2,5,5,10,0.5
Rooster,Inferno,4,11,15,0.26666666666666666
Rooster,Mirage,8,5,13,0.6153846153846154
Rooster,Nuke,12,3,15,0.8
Rooster,Overpass,6,2,8,0.75
Rooster,Vertigo,7,7,14,0.5
Route8,Ancient,1,0,1,1.0
Route8,Anubis,1,0,1,1.0
Route8,Inferno,2,1,3,0.6666666666666666
Route8,Nuke,1,0,1,1.0
Route8,Overpass,1,0,1,1.0
Route8,Vertigo,1,1,2,0.5
Run or Die,Dust2,6,4,10,0.6
Run or Die,Inferno,8,2,10,0.8
Run or Die,Mirage,11,4,15,0.7333333333333333
Run or Die,Nuke,5,3,8,0.625
Run or Die,Overpass,1,10,11,0.09090909090909091
Run or Die,Vertigo,3,4,7,0.42857142857142855
Rush A Rush B,Anubis,0,1,1,0.0
Rush A Rush B,Cobblestone,1,0,1,1.0
Rush A Rush B,Train,0,1,1,0.0
Russia U18,Dust2,0,1,1,0.0
Russia U18,Inferno,0,1,1,0.0
Russia U18,Mirage,1,0,1,1.0
Russia U23,Dust2,1,0,1,1.0
Russia U23,Mirage,1,0,1,1.0
Russian Street Party,Inferno,1,0,1,1.0
Russian Street Party,Mirage,0,1,1,0.0
Russian Street Party,Nuke,0,1,1,0.0
SACRAMENTO,Ancient,1,2,3,0.3333333333333333
SACRAMENTO,Dust2,0,1,1,0.0
SACRAMENTO,Inferno,0,2,2,0.0
SACRAMENTO,Mirage,1,2,3,0.3333333333333333
SACRAMENTO,Nuke,0,1,1,0.0
SACRAMENTO,Overpass,1,2,3,0.3333333333333333
SACRAMENTO,Vertigo,1,1,2,0.5
SAGA,Ancient,0,1,1,0.0
SAGA,Mirage,0,1,1,0.0
SAW,Ancient,42,23,65,0.6461538461538462
SAW,Anubis,4,3,7,0.5714285714285714
SAW,Dust2,22,26,48,0.4583333333333333
SAW,Inferno,29,31,60,0.48333333333333334
SAW,Nuke,51,27,78,0.6538461538461539
SAW,Overpass,13,29,42,0.30952380952380953
SAW,Vertigo,40,26,66,0.6060606060606061
SAW Youngsters,Ancient,2,6,8,0.25
SAW Youngsters,Dust2,2,1,3,0.6666666666666666
SAW Youngsters,Inferno,5,6,11,0.45454545454545453
SAW Youngsters,Mirage,0,2,2,0.0
SAW Youngsters,Nuke,2,4,6,0.3333333333333333
SAW Youngsters,Vertigo,4,0,4,1.0
SAWO,Dust2,0,1,1,0.0
SAWO,Inferno,0,1,1,0.0
SC,Ancient,2,6,8,0.25
SC,Dust2,10,5,15,0.6666666666666666
SC,Inferno,9,4,13,0.6923076923076923
SC,Mirage,14,8,22,0.6363636363636364
SC,Nuke,1,7,8,0.125
SC,Overpass,2,1,3,0.6666666666666666
SC,Vertigo,10,4,14,0.7142857142857143
SD Invicta,Inferno,2,1,3,0.6666666666666666
SD Invicta,Mirage,1,0,1,1.0
SD Invicta,Nuke,1,0,1,1.0
SD Invicta,Vertigo,0,2,2,0.0
SERA,Ancient,0,1,1,0.0
SERA,Overpass,0,1,1,0.0
SG.pro,Inferno,0,1,1,0.0
SG.pro,Mirage,0,1,1,0.0
SHAPE,Ancient,1,0,1,1.0
SHAPE,Dust2,3,3,6,0.5
SHAPE,Inferno,4,5,9,0.4444444444444444
SHAPE,Mirage,3,3,6,0.5
SHAPE,Nuke,2,1,3,0.6666666666666666
SHAPE,Overpass,3,0,3,1.0
SHAPE,Vertigo,1,1,2,0.5
SHPL,Ancient,0,2,2,0.0
SHPL,Nuke,0,2,2,0.0
SHPL,Overpass,0,1,1,0.0
SHUSH,Ancient,0,1,1,0.0
SHUSH,Nuke,0,1,1,0.0
SHYNE,Inferno,0,1,1,0.0
SHYNE,Nuke,0,1,1,0.0
SINNERS,Ancient,31,31,62,0.5
SINNERS,Anubis,1,3,4,0.25
SINNERS,Dust2,0,1,1,0.0
SINNERS,Inferno,43,41,84,0.5119047619047619
SINNERS,Mirage,37,40,77,0.4805194805194805
SINNERS,Nuke,46,38,84,0.5476190476190477
SINNERS,Overpass,44,34,78,0.5641025641025641
SINNERS,Vertigo,42,33,75,0.56
SJ,Ancient,0,1,1,0.0
SJ,Dust2,1,2,3,0.3333333333333333
SJ,Inferno,4,8,12,0.3333333333333333
SJ,Mirage,3,3,6,0.5
SJ,Nuke,1,6,7,0.14285714285714285
SJ,Overpass,3,7,10,0.3
SJ,Vertigo,0,3,3,0.0
SKADE,Ancient,26,22,48,0.5416666666666666
SKADE,Dust2,42,31,73,0.5753424657534246
SKADE,Inferno,57,28,85,0.6705882352941176
SKADE,Mirage,50,22,72,0.6944444444444444
SKADE,Nuke,21,24,45,0.4666666666666667
SKADE,Overpass,44,27,71,0.6197183098591549
SKADE,Vertigo,10,12,22,0.45454545454545453
SKADE X,Ancient,6,5,11,0.5454545454545454
SKADE X,Dust2,0,4,4,0.0
SKADE X,Mirage,4,4,8,0.5
SKADE X,Nuke,2,3,5,0.4
SKADE X,Overpass,3,3,6,0.5
SKADE X,Vertigo,1,3,4,0.25
SKUAK,Dust2,1,0,1,1.0
SKUAK,Inferno,2,0,2,1.0
SKUAK,Mirage,1,1,2,0.5
SMIX,Dust2,0,1,1,0.0
SMIX,Inferno,0,1,1,0.0
SMIX,Mirage,0,1,1,0.0
SMIX,Nuke,0,1,1,0.0
SMIX,Overpass,1,0,1,1.0
SMOAD,Ancient,1,0,1,1.0
SMOAD,Dust2,1,0,1,1.0
SMOAD,Inferno,0,1,1,0.0
SMOAD,Mirage,0,1,1,0.0
SMOAD,Nuke,0,2,2,0.0
SMOAD,Vertigo,0,1,1,0.0
SNOGARD Dragons,Ancient,1,1,2,0.5
SNOGARD Dragons,Inferno,1,2,3,0.3333333333333333
SNOGARD Dragons,Mirage,2,2,4,0.5
SNOGARD Dragons,Nuke,0,1,1,0.0
SNOGARD Dragons,Overpass,1,3,4,0.25
SNRG,Inferno,0,1,1,0.0
SNRG,Nuke,0,1,1,0.0
SNRG,Vertigo,0,1,1,0.0
SQUAD,Dust2,1,0,1,1.0
SQUAD,Inferno,0,1,1,0.0
SQUAD,Nuke,0,1,1,0.0
SSP,Ancient,0,5,5,0.0
SSP,Dust2,2,3,5,0.4
SSP,Inferno,2,6,8,0.25
SSP,Mirage,6,3,9,0.6666666666666666
SSP,Nuke,0,2,2,0.0
SSP,Overpass,3,4,7,0.42857142857142855
SSP,Vertigo,0,2,2,0.0
STMN,Ancient,0,1,1,0.0
STMN,Inferno,2,1,3,0.6666666666666666
STMN,Nuke,1,1,2,0.5
STMN,Overpass,2,0,2,1.0
STMN,Vertigo,0,1,1,0.0
STORM,Inferno,0,1,1,0.0
STORM,Mirage,0,1,1,0.0
SUL,Dust2,1,0,1,1.0
SUL,Inferno,0,1,1,0.0
SUL,Mirage,1,0,1,1.0
SUN,Mirage,0,1,1,0.0
SWMG,Inferno,0,1,1,0.0
SWMG,Nuke,0,1,1,0.0
SWS,Ancient,5,17,22,0.22727272727272727
SWS,Dust2,20,28,48,0.4166666666666667
SWS,Inferno,26,18,44,0.5909090909090909
SWS,Mirage,18,11,29,0.6206896551724138
SWS,Nuke,22,17,39,0.5641025641025641
SWS,Overpass,1,4,5,0.2
SWS,Vertigo,6,19,25,0.24
SYDKOREA,Ancient,0,1,1,0.0
SYDKOREA,Mirage,0,1,1,0.0
Sacrifice,Ancient,0,1,1,0.0
Sacrifice,Inferno,0,1,1,0.0
Sacrifice,Mirage,0,3,3,0.0
Sacrifice,Overpass,0,1,1,0.0
Sahangiller,Ancient,1,0,1,1.0
Sahangiller,Dust2,0,2,2,0.0
Sahangiller,Inferno,5,3,8,0.625
Sahangiller,Mirage,4,1,5,0.8
Sahangiller,Overpass,0,1,1,0.0
Sahangiller,Vertigo,0,2,2,0.0
Saints,Inferno,0,3,3,0.0
Saints,Mirage,1,0,1,1.0
Saints,Overpass,1,1,2,0.5
Sakrifica,Inferno,0,1,1,0.0
Sakrifica,Nuke,0,1,1,0.0
SalutLA,Mirage,0,1,1,0.0
Sampi,Ancient,4,11,15,0.26666666666666666
Sampi,Anubis,0,2,2,0.0
Sampi,Dust2,1,7,8,0.125
Sampi,Inferno,3,12,15,0.2
Sampi,Mirage,1,7,8,0.125
Sampi,Nuke,2,3,5,0.4
Sampi,Overpass,4,5,9,0.4444444444444444
Sampi,Vertigo,2,7,9,0.2222222222222222
Sangal,Ancient,25,21,46,0.5434782608695652
Sangal,Anubis,2,2,4,0.5
Sangal,Dust2,15,14,29,0.5172413793103449
Sangal,Inferno,31,31,62,0.5
Sangal,Mirage,20,14,34,0.5882352941176471
Sangal,Nuke,4,1,5,0.8
Sangal,Overpass,18,17,35,0.5142857142857142
Sangal,Vertigo,20,17,37,0.5405405405405406
Sanguine,Ancient,0,1,1,0.0
Sanguine,Dust2,0,1,1,0.0
Sanguine,Inferno,1,4,5,0.2
Sanguine,Mirage,2,3,5,0.4
Sanguine,Nuke,2,0,2,1.0
Sanguine,Vertigo,1,2,3,0.3333333333333333
Santos,Ancient,0,3,3,0.0
Santos,Dust2,0,4,4,0.0
Santos,Inferno,3,4,7,0.42857142857142855
Santos,Mirage,1,1,2,0.5
Santos,Nuke,2,3,5,0.4
Santos,Overpass,0,2,2,0.0
Santos,Vertigo,2,1,3,0.6666666666666666
Sashi,Ancient,2,7,9,0.2222222222222222
Sashi,Dust2,0,1,1,0.0
Sashi,Inferno,1,2,3,0.3333333333333333
Sashi,Mirage,2,2,4,0.5
Sashi,Nuke,6,5,11,0.5454545454545454
Sashi,Overpass,2,5,7,0.2857142857142857
Sashi,Vertigo,1,4,5,0.2
Savage,Ancient,12,5,17,0.7058823529411765
Savage,Dust2,7,10,17,0.4117647058823529
Savage,Inferno,11,12,23,0.4782608695652174
Savage,Mirage,8,4,12,0.6666666666666666
Savage,Nuke,0,1,1,0.0
Savage,Overpass,4,9,13,0.3076923076923077
Savage,Vertigo,8,11,19,0.42105263157894735
Save's,Dust2,1,1,2,0.5
Save's,Inferno,1,0,1,1.0
Save's,Mirage,1,0,1,1.0
Save's,Nuke,2,1,3,0.6666666666666666
Save's,Overpass,0,2,2,0.0
Save's,Vertigo,0,4,4,0.0
Secret,Dust2,0,1,1,0.0
Secret,Inferno,0,1,1,0.0
Secret,Nuke,0,1,1,0.0
Secret Club,Inferno,0,1,1,0.0
Secret Club,Mirage,1,0,1,1.0
Secret Club,Overpass,0,1,1,0.0
Sector One,Inferno,0,1,1,0.0
Sector One,Mirage,1,0,1,1.0
Sector One,Overpass,0,1,1,0.0
Selecao do bt0,Inferno,0,1,1,0.0
Selecao do bt0,Nuke,0,1,1,0.0
Serbia,Dust2,1,1,2,0.5
Serbia,Inferno,2,0,2,1.0
Serbia,Overpass,0,1,1,0.0
Sestri,Dust2,1,1,2,0.5
Sestri,Inferno,1,4,5,0.2
Sestri,Mirage,2,2,4,0.5
Sestri,Nuke,0,1,1,0.0
SevenIZI,Dust2,0,1,1,0.0
SevenIZI,Inferno,0,2,2,0.0
SevenIZI,Overpass,0,1,1,0.0
Shababs Botten,Nuke,0,1,1,0.0
Sharks,Ancient,16,12,28,0.5714285714285714
Sharks,Anubis,3,0,3,1.0
Sharks,Dust2,22,16,38,0.5789473684210527
Sharks,Inferno,15,11,26,0.5769230769230769
Sharks,Mirage,30,15,45,0.6666666666666666
Sharks,Nuke,16,22,38,0.42105263157894735
Sharks,Overpass,0,1,1,0.0
Sharks,Vertigo,13,13,26,0.5
Shmetaland,Dust2,0,1,1,0.0
Shmetaland,Nuke,0,1,1,0.0
Silent Insanity,Dust2,1,0,1,1.0
Silent Insanity,Inferno,0,1,1,0.0
Silent Insanity,Mirage,0,1,1,0.0
Singularity,Ancient,3,9,12,0.25
Singularity,Anubis,0,1,1,0.0
Singularity,Dust2,6,2,8,0.75
Singularity,Inferno,2,4,6,0.3333333333333333
Singularity,Mirage,5,3,8,0.625
Singularity,Nuke,11,4,15,0.7333333333333333
Singularity,Overpass,4,7,11,0.36363636363636365
Singularity,Vertigo,0,1,1,0.0
Sinister5,Dust2,1,2,3,0.3333333333333333
Sinister5,Inferno,1,2,3,0.3333333333333333
Sinister5,Mirage,2,0,2,1.0
Sinister5,Overpass,1,1,2,0.5
Sinister5,Vertigo,1,0,1,1.0
Skelp,Mirage,1,0,1,1.0
Skelp,Overpass,1,0,1,1.0
Skelp,Vertigo,0,1,1,0.0
Skullcracker,Ancient,0,3,3,0.0
Skullcracker,Inferno,1,1,2,0.5
Skullcracker,Nuke,0,1,1,0.0
Skullcracker,Vertigo,2,0,2,1.0
Slay,Inferno,0,1,1,0.0
Slay,Mirage,0,1,1,0.0
Slovakia,Inferno,3,3,6,0.5
Slovakia,Mirage,2,2,4,0.5
Slovakia,Overpass,0,1,1,0.0
Slovakia,Vertigo,1,1,2,0.5
Smile,Ancient,0,1,1,0.0
Smile,Inferno,0,1,1,0.0
Smile,Overpass,0,1,1,0.0
Smile,Vertigo,0,1,1,0.0
Snakes Den,Ancient,2,3,5,0.4
Snakes Den,Dust2,2,5,7,0.2857142857142857
Snakes Den,Inferno,8,9,17,0.47058823529411764
Snakes Den,Mirage,3,2,5,0.6
Snakes Den,Nuke,4,8,12,0.3333333333333333
Snakes Den,Overpass,2,4,6,0.3333333333333333
Snakes Den,Vertigo,4,12,16,0.25
Sniper Delta,Inferno,2,0,2,1.0
Sniper Delta,Vertigo,2,0,2,1.0
Sojoga,Ancient,0,1,1,0.0
Sojoga,Dust2,6,1,7,0.8571428571428571
Sojoga,Inferno,4,3,7,0.5714285714285714
Sojoga,Mirage,2,1,3,0.6666666666666666
Sojoga,Nuke,5,2,7,0.7142857142857143
Sojoga,Overpass,2,2,4,0.5
Sotano,Dust2,0,1,1,0.0
Sotano,Mirage,0,1,1,0.0
Sotano,Overpass,0,1,1,0.0
South,Dust2,1,0,1,1.0
South,Inferno,2,2,4,0.5
South,Mirage,1,1,2,0.5
South,Nuke,2,0,2,1.0
South,Overpass,1,2,3,0.3333333333333333
South,Vertigo,0,2,2,0.0
Spain,Dust2,0,2,2,0.0
Spain,Inferno,3,1,4,0.75
Spain,Mirage,0,1,1,0.0
Spain,Nuke,1,0,1,1.0
Spain,Overpass,1,1,2,0.5
SpeedRunners,Ancient,1,0,1,1.0
SpeedRunners,Inferno,0,1,1,0.0
SpeedRunners,Overpass,0,1,1,0.0
Spirit,Ancient,26,11,37,0.7027027027027027
Spirit,Anubis,3,2,5,0.6
Spirit,Dust2,22,17,39,0.5641025641025641
Spirit,Inferno,4,15,19,0.21052631578947367
Spirit,Mirage,16,25,41,0.3902439024390244
Spirit,Nuke,30,23,53,0.5660377358490566
Spirit,Overpass,20,13,33,0.6060606060606061
Spirit,Vertigo,12,8,20,0.6
Spirit Academy,Anubis,1,4,5,0.2
Spirit Academy,Dust2,15,12,27,0.5555555555555556
Spirit Academy,Inferno,13,9,22,0.5909090909090909
Spirit Academy,Mirage,32,24,56,0.5714285714285714
Spirit Academy,Nuke,19,20,39,0.48717948717948717
Spirit Academy,Overpass,12,10,22,0.5454545454545454
Spirit Academy,Vertigo,23,15,38,0.6052631578947368
Spooky Squad,Mirage,0,1,1,0.0
Sprenty,Inferno,0,1,1,0.0
Sprenty,Vertigo,0,1,1,0.0
Springroll,Dust2,1,0,1,1.0
Springroll,Inferno,1,2,3,0.3333333333333333
Springroll,Mirage,2,1,3,0.6666666666666666
Springroll,Nuke,0,3,3,0.0
Springroll,Overpass,1,1,2,0.5
Sprout,Ancient,48,27,75,0.64
Sprout,Anubis,0,4,4,0.0
Sprout,Dust2,37,24,61,0.6065573770491803
Sprout,Inferno,42,27,69,0.6086956521739131
Sprout,Mirage,21,30,51,0.4117647058823529
Sprout,Nuke,12,20,32,0.375
Sprout,Overpass,30,24,54,0.5555555555555556
Sprout,Vertigo,46,32,78,0.5897435897435898
Squirtle Squad,Ancient,1,0,1,1.0
Squirtle Squad,Dust2,1,1,2,0.5
Squirtle Squad,Inferno,2,3,5,0.4
Squirtle Squad,Mirage,0,4,4,0.0
Squirtle Squad,Vertigo,1,0,1,1.0
Staffan Gymnasiet,Inferno,1,0,1,1.0
Staffan Gymnasiet,Mirage,0,1,1,0.0
Staffan Gymnasiet,Nuke,0,1,1,0.0
Stanley's Harem,Inferno,1,0,1,1.0
Stanley's Harem,Nuke,0,1,1,0.0
Stanley's Harem,Overpass,0,1,1,0.0
Stanley's Harem,Vertigo,1,0,1,1.0
Star Games,Dust2,0,1,1,0.0
Star Games,Inferno,0,1,1,0.0
Star Games,Overpass,0,1,1,0.0
Stars Horizon,Ancient,8,13,21,0.38095238095238093
Stars Horizon,Dust2,3,16,19,0.15789473684210525
Stars Horizon,Inferno,2,3,5,0.4
Stars Horizon,Mirage,5,6,11,0.45454545454545453
Stars Horizon,Nuke,9,11,20,0.45
Stars Horizon,Overpass,7,5,12,0.5833333333333334
Stars Horizon,Vertigo,7,9,16,0.4375
Stealth,Ancient,0,1,1,0.0
Stealth,Inferno,1,4,5,0.2
Stealth,Mirage,1,2,3,0.3333333333333333
Stealth,Nuke,3,1,4,0.75
Stealth,Overpass,1,1,2,0.5
Stealth,Vertigo,1,1,2,0.5
Steel Helmet,Ancient,1,1,2,0.5
Steel Helmet,Dust2,3,1,4,0.75
Steel Helmet,Inferno,1,1,2,0.5
Steel Helmet,Mirage,2,3,5,0.4
Steel Helmet,Nuke,0,2,2,0.0
Steel Helmet,Overpass,0,2,2,0.0
Stinkdiertjes,Nuke,0,1,1,0.0
Stinkdiertjes,Vertigo,0,1,1,0.0
Stirlz Fans,Nuke,0,1,1,0.0
StoichkovPeek,Inferno,1,1,2,0.5
StoichkovPeek,Nuke,1,0,1,1.0
StoichkovPeek,Overpass,1,0,1,1.0
StoichkovPeek,Vertigo,1,0,1,1.0
Stone,Ancient,0,2,2,0.0
Stone,Dust2,5,12,17,0.29411764705882354
Stone,Inferno,5,5,10,0.5
Stone,Mirage,0,4,4,0.0
Stone,Nuke,3,6,9,0.3333333333333333
Stone,Overpass,5,9,14,0.35714285714285715
Stone,Vertigo,4,8,12,0.3333333333333333
Storm Wolves,Mirage,0,1,1,0.0
Storm Wolves,Nuke,0,1,1,0.0
Stream Snipers,Inferno,0,1,1,0.0
Stream Snipers,Overpass,0,1,1,0.0
Strife,Ancient,3,2,5,0.6
Strife,Anubis,2,1,3,0.6666666666666666
Strife,Dust2,6,4,10,0.6
Strife,Inferno,25,32,57,0.43859649122807015
Strife,Mirage,34,30,64,0.53125
Strife,Nuke,25,29,54,0.46296296296296297
Strife,Overpass,26,24,50,0.52
Strife,Vertigo,8,14,22,0.36363636363636365
StrikeX,Mirage,0,1,1,0.0
Strive in chaos,Ancient,1,2,3,0.3333333333333333
Strive in chaos,Dust2,1,1,2,0.5
Strive in chaos,Inferno,5,4,9,0.5555555555555556
Strive in chaos,Mirage,6,2,8,0.75
Strive in chaos,Nuke,0,1,1,0.0
Strive in chaos,Overpass,2,1,3,0.6666666666666666
Strive in chaos,Vertigo,2,3,5,0.4
Stuck in Iceland,Dust2,0,1,1,0.0
Stuck in Iceland,Inferno,0,2,2,0.0
Stuck in Iceland,Vertigo,0,1,1,0.0
Sudor,Dust2,1,0,1,1.0
Sudor,Nuke,0,1,1,0.0
Sunds Gymnasiet,Ancient,0,1,1,0.0
Sunds Gymnasiet,Inferno,1,1,2,0.5
Sunds Gymnasiet,Mirage,1,0,1,1.0
Sunds Gymnasiet,Nuke,1,0,1,1.0
Sunds Gymnasiet,Overpass,1,0,1,1.0
Supremacy,Ancient,0,1,1,0.0
Supremacy,Inferno,3,1,4,0.75
Supremacy,Mirage,2,2,4,0.5
Supremacy,Nuke,0,3,3,0.0
Supremacy,Overpass,0,1,1,0.0
Supremacy,Vertigo,1,2,3,0.3333333333333333
SurelyOneDay,Inferno,0,1,1,0.0
SurelyOneDay,Mirage,0,1,1,0.0
Sutti's Money Crew,Nuke,1,0,1,1.0
Sutti's Money Crew,Overpass,0,1,1,0.0
Sutti's Money Crew,Vertigo,1,1,2,0.5
Sweden,Inferno,3,2,5,0.6
Sweden,Mirage,2,5,7,0.2857142857142857
Sweden,Overpass,2,2,4,0.5
Sweden,Train,0,1,1,0.0
Sweden,Vertigo,3,1,4,0.75
Sylyx,Ancient,2,1,3,0.6666666666666666
Sylyx,Dust2,1,2,3,0.3333333333333333
Sylyx,Inferno,2,0,2,1.0
Sylyx,Mirage,0,1,1,0.0
Sylyx,Nuke,1,3,4,0.25
Sylyx,Overpass,1,1,2,0.5
Sylyx,Vertigo,1,2,3,0.3333333333333333
Synergy Reborn,Inferno,0,2,2,0.0
Synergy Reborn,Mirage,0,1,1,0.0
Synergy Reborn,Nuke,1,1,2,0.5
Synergy Reborn,Overpass,0,1,1,0.0
Synergy Reborn,Vertigo,2,0,2,1.0
Synthetic,Inferno,3,3,6,0.5
Synthetic,Mirage,2,2,4,0.5
Synthetic,Nuke,1,1,2,0.5
Synthetic,Overpass,2,2,4,0.5
Synthetic,Vertigo,3,2,5,0.6
SГЈo Caetano,Ancient,1,1,2,0.5
SГЈo Caetano,Dust2,0,3,3,0.0
SГЈo Caetano,Inferno,3,3,6,0.5
SГЈo Caetano,Mirage,4,2,6,0.6666666666666666
SГЈo Caetano,Nuke,8,0,8,1.0
SГЈo Caetano,Overpass,1,1,2,0.5
TAG,Ancient,2,4,6,0.3333333333333333
TAG,Dust2,6,5,11,0.5454545454545454
TAG,Inferno,2,7,9,0.2222222222222222
TAG,Mirage,9,6,15,0.6
TAG,Nuke,14,3,17,0.8235294117647058
TAG,Overpass,4,3,7,0.5714285714285714
TAG,Vertigo,0,1,1,0.0
TBB,Dust2,0,1,1,0.0
TBB,Inferno,0,2,2,0.0
TBB,Mirage,0,1,1,0.0
TBC,Ancient,1,0,1,1.0
TBC,Dust2,1,3,4,0.25
TBC,Inferno,1,1,2,0.5
TBC,Mirage,1,2,3,0.3333333333333333
TBC,Nuke,2,1,3,0.6666666666666666
TBC,Overpass,0,4,4,0.0
TENSTAR,Ancient,1,2,3,0.3333333333333333
TENSTAR,Anubis,1,0,1,1.0
TENSTAR,Inferno,3,1,4,0.75
TENSTAR,Mirage,2,0,2,1.0
TENSTAR,Overpass,0,4,4,0.0
TENSTAR,Vertigo,0,4,4,0.0
TGJ,Inferno,0,1,1,0.0
TGJ,Nuke,0,1,1,0.0
TITANS,Ancient,1,2,3,0.3333333333333333
TITANS,Dust2,3,3,6,0.5
TITANS,Inferno,3,3,6,0.5
TITANS,Mirage,5,3,8,0.625
TITANS,Nuke,1,2,3,0.3333333333333333
TITANS,Overpass,1,1,2,0.5
TMVG,Inferno,1,2,3,0.3333333333333333
TMVG,Nuke,1,2,3,0.3333333333333333
TOP Gs,Mirage,0,1,1,0.0
TOP5,Ancient,1,0,1,1.0
TOP5,Inferno,1,0,1,1.0
TOP5,Mirage,1,0,1,1.0
TOP5,Nuke,0,2,2,0.0
TOP5,Overpass,1,0,1,1.0
TPT,Dust2,0,2,2,0.0
TPT,Inferno,0,1,1,0.0
TPT,Nuke,0,1,1,0.0
TPT,Overpass,0,1,1,0.0
TRAFFIC Tashkent,Inferno,1,0,1,1.0
TRAFFIC Tashkent,Mirage,1,0,1,1.0
TTC,Ancient,3,3,6,0.5
TTC,Dust2,2,2,4,0.5
TTC,Inferno,3,5,8,0.375
TTC,Mirage,2,7,9,0.2222222222222222
TTC,Nuke,2,2,4,0.5
TTC,Overpass,4,0,4,1.0
TYLOO,Ancient,14,9,23,0.6086956521739131
TYLOO,Anubis,4,2,6,0.6666666666666666
TYLOO,Dust2,7,7,14,0.5
TYLOO,Inferno,22,14,36,0.6111111111111112
TYLOO,Mirage,15,13,28,0.5357142857142857
TYLOO,Nuke,0,1,1,0.0
TYLOO,Overpass,15,9,24,0.625
TYLOO,Vertigo,14,5,19,0.7368421052631579
Take Charge,Ancient,2,2,4,0.5
Take Charge,Anubis,0,1,1,0.0
Take Charge,Dust2,0,1,1,0.0
Take Charge,Inferno,2,1,3,0.6666666666666666
Take Charge,Mirage,0,2,2,0.0
Take Charge,Nuke,1,3,4,0.25
Take Charge,Overpass,2,5,7,0.2857142857142857
Take Charge,Vertigo,0,1,1,0.0
Take Flyte,Ancient,3,3,6,0.5
Take Flyte,Anubis,2,2,4,0.5
Take Flyte,Dust2,1,3,4,0.25
Take Flyte,Inferno,5,5,10,0.5
Take Flyte,Mirage,6,3,9,0.6666666666666666
Take Flyte,Nuke,9,5,14,0.6428571428571429
Take Flyte,Overpass,3,1,4,0.75
Take Flyte,Vertigo,6,4,10,0.6
Take me away,Anubis,0,1,1,0.0
Take me away,Inferno,3,0,3,1.0
Take me away,Mirage,1,1,2,0.5
Take me away,Nuke,1,1,2,0.5
Take me away,Vertigo,2,0,2,1.0
Task Force 141,Ancient,0,1,1,0.0
Task Force 141,Inferno,0,1,1,0.0
Task Force 141,Mirage,1,2,3,0.3333333333333333
Task Force 141,Nuke,0,1,1,0.0
Task Force 141,Overpass,0,1,1,0.0
Task Force 141,Vertigo,1,1,2,0.5
Team Buster,Ancient,0,2,2,0.0
Team Buster,Inferno,1,0,1,1.0
Team Buster,Mirage,0,1,1,0.0
Team Buster,Nuke,0,1,1,0.0
Team Evelone192,Ancient,1,1,2,0.5
Team Evelone192,Dust2,0,1,1,0.0
Team Evelone192,Inferno,0,1,1,0.0
Team Evelone192,Mirage,0,1,1,0.0
Team Evelone192,Nuke,2,0,2,1.0
Team Flash,Overpass,1,0,1,1.0
Team GeT_RiGhT,Mirage,1,0,1,1.0
Team Smoke,Overpass,0,1,1,0.0
Team StRoGo,Ancient,3,0,3,1.0
Team StRoGo,Dust2,2,1,3,0.6666666666666666
Team StRoGo,Inferno,1,1,2,0.5
Team StRoGo,Mirage,1,1,2,0.5
Team shoke,Ancient,0,1,1,0.0
Team shoke,Dust2,1,1,2,0.5
Team shoke,Inferno,1,1,2,0.5
Team shoke,Mirage,2,0,2,1.0
Team shoke,Nuke,0,1,1,0.0
TeamOne,Ancient,16,25,41,0.3902439024390244
TeamOne,Anubis,1,1,2,0.5
TeamOne,Dust2,18,15,33,0.5454545454545454
TeamOne,Inferno,42,34,76,0.5526315789473685
TeamOne,Mirage,48,24,72,0.6666666666666666
TeamOne,Nuke,31,27,58,0.5344827586206896
TeamOne,Overpass,29,18,47,0.6170212765957447
TeamOne,Vertigo,1,2,3,0.3333333333333333
Temperate,Ancient,1,0,1,1.0
Temperate,Inferno,2,1,3,0.6666666666666666
Temperate,Nuke,2,3,5,0.4
Temperate,Overpass,1,3,4,0.25
Temperate,Vertigo,1,1,2,0.5
Temperate SCO,Mirage,0,1,1,0.0
Temperate SCO,Overpass,0,1,1,0.0
Temperate SCO,Vertigo,1,0,1,1.0
Tempest,Inferno,0,3,3,0.0
Tempest,Mirage,1,1,2,0.5
Tempest,Vertigo,0,1,1,0.0
Thani,Inferno,0,1,1,0.0
Thani,Mirage,0,2,2,0.0
Thani,Nuke,1,0,1,1.0
Thani,Overpass,1,0,1,1.0
The Big Dogs,Ancient,4,0,4,1.0
The Big Dogs,Dust2,0,1,1,0.0
The Big Dogs,Inferno,1,0,1,1.0
The Big Dogs,Mirage,1,1,2,0.5
The Big Dogs,Nuke,9,1,10,0.9
The Big Dogs,Overpass,0,2,2,0.0
The Big Dogs,Vertigo,3,4,7,0.42857142857142855
The Chosen Few,Dust2,1,1,2,0.5
The Chosen Few,Inferno,1,0,1,1.0
The Chosen Few,Nuke,0,1,1,0.0
The Incas,Inferno,0,2,2,0.0
The Last Resort,Inferno,0,1,1,0.0
The Last Resort,Nuke,0,2,2,0.0
The Last Resort,Overpass,0,1,1,0.0
The Muppets,Ancient,0,1,1,0.0
The Muppets,Mirage,0,1,1,0.0
The Neighbours,Ancient,0,1,1,0.0
The Neighbours,Nuke,1,1,2,0.5
The Neighbours,Overpass,2,0,2,1.0
The Neighbours,Vertigo,1,0,1,1.0
The Prodigies,Ancient,1,1,2,0.5
The Prodigies,Anubis,2,0,2,1.0
The Prodigies,Dust2,0,1,1,0.0
The Prodigies,Inferno,1,3,4,0.25
The Prodigies,Mirage,0,3,3,0.0
The Prodigies,Nuke,1,2,3,0.3333333333333333
The Prodigies,Overpass,0,1,1,0.0
The Shine,Dust2,0,1,1,0.0
The Shine,Mirage,2,1,3,0.6666666666666666
The Shine,Nuke,0,1,1,0.0
The Shine,Vertigo,0,1,1,0.0
The Sisterhood,Inferno,1,1,2,0.5
The Sisterhood,Mirage,1,1,2,0.5
The Union,Ancient,8,12,20,0.4
The Union,Dust2,11,11,22,0.5
The Union,Inferno,24,10,34,0.7058823529411765
The Union,Mirage,3,8,11,0.2727272727272727
The Union,Overpass,5,6,11,0.45454545454545453
The Union,Vertigo,7,2,9,0.7777777777777778
TheDice,Inferno,1,0,1,1.0
TheDice,Nuke,0,1,1,0.0
TheDice,Overpass,0,1,1,0.0
TheMongolz,Ancient,1,2,3,0.3333333333333333
TheMongolz,Dust2,2,4,6,0.3333333333333333
TheMongolz,Inferno,2,7,9,0.2222222222222222
TheMongolz,Mirage,2,4,6,0.3333333333333333
TheMongolz,Nuke,4,7,11,0.36363636363636365
TheMongolz,Overpass,0,1,1,0.0
TheMongolz,Vertigo,0,1,1,0.0
Third Impact,Ancient,3,5,8,0.375
Third Impact,Dust2,0,1,1,0.0
Third Impact,Inferno,9,17,26,0.34615384615384615
Third Impact,Mirage,4,26,30,0.13333333333333333
Third Impact,Nuke,12,19,31,0.3870967741935484
Third Impact,Overpass,7,11,18,0.3888888888888889
Third Impact,Vertigo,2,4,6,0.3333333333333333
Throw Potential,Dust2,1,1,2,0.5
Throw Potential,Inferno,0,2,2,0.0
Throw Potential,Mirage,1,0,1,1.0
Throw Potential,Nuke,1,0,1,1.0
Throw Potential,Overpass,0,1,1,0.0
ThunderFlash,Ancient,2,2,4,0.5
ThunderFlash,Anubis,1,1,2,0.5
ThunderFlash,Dust2,0,1,1,0.0
ThunderFlash,Mirage,0,2,2,0.0
ThunderFlash,Nuke,6,2,8,0.75
ThunderFlash,Overpass,0,3,3,0.0
ThunderFlash,Vertigo,0,7,7,0.0
Thunderbolts,Ancient,1,1,2,0.5
Thunderbolts,Dust2,1,2,3,0.3333333333333333
Thunderbolts,Inferno,1,1,2,0.5
Thunderbolts,Mirage,1,1,2,0.5
Thunderbolts,Nuke,1,1,2,0.5
Thunderbolts,Overpass,0,1,1,0.0
ToA,Dust2,1,1,2,0.5
ToA,Mirage,0,1,1,0.0
ToA,Nuke,0,1,1,0.0
ToA,Vertigo,0,1,1,0.0
Tokyo Revengers,Inferno,1,0,1,1.0
Tokyo Revengers,Mirage,0,1,1,0.0
Tokyo Revengers,Overpass,0,1,1,0.0
TotalePro,Dust2,0,1,1,0.0
TotalePro,Inferno,1,2,3,0.3333333333333333
TotalePro,Nuke,0,2,2,0.0
TotalePro,Overpass,1,0,1,1.0
Totalne Gituwy,Dust2,0,1,1,0.0
Totalne Gituwy,Vertigo,0,1,1,0.0
Touch Point,Ancient,2,3,5,0.4
Touch Point,Dust2,0,2,2,0.0
Touch Point,Inferno,5,4,9,0.5555555555555556
Touch Point,Mirage,2,5,7,0.2857142857142857
Touch Point,Nuke,2,2,4,0.5
Touch Point,Overpass,2,4,6,0.3333333333333333
Touch Point,Vertigo,1,2,3,0.3333333333333333
Toxic,Ancient,0,1,1,0.0
Toxic,Vertigo,0,1,1,0.0
TrEa,Inferno,0,1,1,0.0
TrEa,Vertigo,0,1,1,0.0
Tranquillum,Ancient,2,1,3,0.6666666666666666
Tranquillum,Dust2,2,1,3,0.6666666666666666
Tranquillum,Mirage,5,3,8,0.625
Tranquillum,Nuke,3,1,4,0.75
Tranquillum,Overpass,0,3,3,0.0
Tranquillum,Vertigo,2,5,7,0.2857142857142857
Trasko,Ancient,6,2,8,0.75
Trasko,Dust2,1,1,2,0.5
Trasko,Inferno,5,6,11,0.45454545454545453
Trasko,Mirage,2,7,9,0.2222222222222222
Trasko,Nuke,7,7,14,0.5
Trasko,Overpass,10,4,14,0.7142857142857143
Trasko,Vertigo,10,8,18,0.5555555555555556
Tribute to Tribute,Inferno,2,3,5,0.4
Tribute to Tribute,Mirage,2,2,4,0.5
Tribute to Tribute,Overpass,0,1,1,0.0
Tribute to Tribute,Vertigo,0,1,1,0.0
Tricked,Ancient,18,21,39,0.46153846153846156
Tricked,Dust2,5,10,15,0.3333333333333333
Tricked,Inferno,28,36,64,0.4375
Tricked,Mirage,30,55,85,0.35294117647058826
Tricked,Nuke,70,47,117,0.5982905982905983
Tricked,Overpass,45,36,81,0.5555555555555556
Tricked,Vertigo,34,38,72,0.4722222222222222
Tricked Future,Inferno,0,1,1,0.0
Tricked Future,Mirage,0,1,1,0.0
Triple 6,Dust2,0,2,2,0.0
Triple 6,Inferno,1,2,3,0.3333333333333333
Triple 6,Mirage,1,1,2,0.5
Triple 6,Overpass,1,0,1,1.0
Triple 6,Vertigo,1,2,3,0.3333333333333333
Triton,Dust2,3,1,4,0.75
Triton,Inferno,1,0,1,1.0
Triton,Mirage,0,2,2,0.0
Triton,Nuke,2,0,2,1.0
Triton,Overpass,0,3,3,0.0
Triton,Vertigo,4,0,4,1.0
Triumph,Ancient,3,1,4,0.75
Triumph,Dust2,5,6,11,0.45454545454545453
Triumph,Inferno,25,18,43,0.5813953488372093
Triumph,Mirage,13,9,22,0.5909090909090909
Triumph,Nuke,17,9,26,0.6538461538461539
Triumph,Overpass,8,13,21,0.38095238095238093
Triumph,Vertigo,3,6,9,0.3333333333333333
TropiCaos,Ancient,2,2,4,0.5
TropiCaos,Anubis,0,1,1,0.0
TropiCaos,Dust2,0,1,1,0.0
TropiCaos,Inferno,1,2,3,0.3333333333333333
TropiCaos,Mirage,0,2,2,0.0
TropiCaos,Nuke,1,1,2,0.5
TropiCaos,Overpass,2,3,5,0.4
Troublemakers,Inferno,0,1,1,0.0
Troublemakers,Mirage,0,1,1,0.0
Twisted Minds,Anubis,1,0,1,1.0
Twisted Minds,Inferno,1,1,2,0.5
Twisted Minds,Mirage,1,0,1,1.0
Twisted Minds,Overpass,1,0,1,1.0
Twisted Minds,Vertigo,0,1,1,0.0
Typ as nice,Dust2,0,1,1,0.0
Typ as nice,Inferno,0,1,1,0.0
Typ as nice,Mirage,3,0,3,1.0
Typ as nice,Overpass,0,1,1,0.0
Typ as nice,Vertigo,2,0,2,1.0
UDP,Ancient,0,1,1,0.0
UDP,Dust2,0,3,3,0.0
UDP,Inferno,1,0,1,1.0
UDP,Mirage,2,1,3,0.6666666666666666
UDP,Overpass,0,1,1,0.0
UFG,Inferno,1,0,1,1.0
UFG,Vertigo,1,0,1,1.0
UNGENTIUM,Ancient,26,32,58,0.4482758620689655
UNGENTIUM,Anubis,1,4,5,0.2
UNGENTIUM,Dust2,14,22,36,0.3888888888888889
UNGENTIUM,Inferno,13,27,40,0.325
UNGENTIUM,Mirage,19,20,39,0.48717948717948717
UNGENTIUM,Nuke,14,10,24,0.5833333333333334
UNGENTIUM,Overpass,0,14,14,0.0
UNGENTIUM,Vertigo,15,19,34,0.4411764705882353
UNO MILLE,Ancient,5,5,10,0.5
UNO MILLE,Dust2,3,4,7,0.42857142857142855
UNO MILLE,Inferno,2,3,5,0.4
UNO MILLE,Mirage,7,5,12,0.5833333333333334
UNO MILLE,Nuke,13,2,15,0.8666666666666667
UNO MILLE,Overpass,3,1,4,0.75
UNO MILLE,Vertigo,1,2,3,0.3333333333333333
UYU,Dust2,1,1,2,0.5
UYU,Inferno,3,5,8,0.375
UYU,Mirage,3,4,7,0.42857142857142855
UYU,Nuke,2,1,3,0.6666666666666666
UYU,Overpass,1,1,2,0.5
UYU,Vertigo,3,3,6,0.5
Ukraine,Dust2,3,0,3,1.0
Ukraine,Inferno,2,1,3,0.6666666666666666
Ukraine,Mirage,2,2,4,0.5
Ukraine,Vertigo,1,1,2,0.5
Ultimate Power,Inferno,0,1,1,0.0
Ultimate Power,Mirage,0,1,1,0.0
UnDeRdOgS,Overpass,0,1,1,0.0
UnDeRdOgS,Vertigo,0,1,1,0.0
Uncharted Territory,Dust2,0,1,1,0.0
Uncharted Territory,Overpass,0,1,1,0.0
Undefeated,Dust2,0,1,1,0.0
Undefeated,Inferno,1,0,1,1.0
Undefeated,Mirage,0,1,1,0.0
Underground Kings,Ancient,2,0,2,1.0
Underground Kings,Inferno,0,1,1,0.0
Underground Kings,Nuke,1,1,2,0.5
Underground Kings,Overpass,0,2,2,0.0
Underground Kings,Vertigo,1,0,1,1.0
Unicorns of Love,Ancient,0,1,1,0.0
Unicorns of Love,Dust2,1,1,2,0.5
Unicorns of Love,Inferno,0,3,3,0.0
Unicorns of Love,Nuke,1,0,1,1.0
Unicorns of Love,Overpass,1,3,4,0.25
Unicorns of Love,Vertigo,0,2,2,0.0
Uninvited,Mirage,0,1,1,0.0
Uninvited,Overpass,0,1,1,0.0
Union88,Nuke,0,1,1,0.0
Unique,Ancient,15,15,30,0.5
Unique,Dust2,18,13,31,0.5806451612903226
Unique,Inferno,13,12,25,0.52
Unique,Mirage,10,22,32,0.3125
Unique,Nuke,2,2,4,0.5
Unique,Overpass,24,16,40,0.6
Unique,Vertigo,7,6,13,0.5384615384615384
Uniquestars,Inferno,1,0,1,1.0
Uniquestars,Mirage,1,0,1,1.0
Universe Five,Mirage,0,1,1,0.0
Unjustified,Ancient,2,5,7,0.2857142857142857
Unjustified,Dust2,2,1,3,0.6666666666666666
Unjustified,Inferno,6,13,19,0.3157894736842105
Unjustified,Mirage,8,8,16,0.5
Unjustified,Nuke,3,8,11,0.2727272727272727
Unjustified,Overpass,1,6,7,0.14285714285714285
Unjustified,Vertigo,4,6,10,0.4
Upswing,Dust2,0,1,1,0.0
Upswing,Inferno,1,0,1,1.0
Upswing,Mirage,0,1,1,0.0
Upswing,Nuke,1,2,3,0.3333333333333333
Upswing,Vertigo,1,1,2,0.5
Uptime United,Mirage,0,1,1,0.0
VALLEA,Inferno,0,1,1,0.0
VALLEA,Overpass,0,1,1,0.0
VAMOS,Dust2,0,1,1,0.0
VAMOS,Overpass,0,1,1,0.0
VAMOSTARS,Ancient,0,1,1,0.0
VAMOSTARS,Dust2,1,0,1,1.0
VAMOSTARS,Inferno,0,1,1,0.0
VAMOSTARS,Mirage,1,0,1,1.0
VAMOSTARS,Vertigo,0,1,1,0.0
VELOX,Ancient,8,6,14,0.5714285714285714
VELOX,Dust2,0,2,2,0.0
VELOX,Inferno,2,8,10,0.2
VELOX,Mirage,1,1,2,0.5
VELOX,Nuke,3,7,10,0.3
VELOX,Overpass,2,6,8,0.25
VELOX,Vertigo,1,4,5,0.2
VELOX Academy,Dust2,0,1,1,0.0
VELOX Academy,Inferno,1,0,1,1.0
VELOX Academy,Mirage,0,1,1,0.0
VELOX Academy,Nuke,1,2,3,0.3333333333333333
VELOX Academy,Vertigo,0,1,1,0.0
VERTEX,Ancient,4,7,11,0.36363636363636365
VERTEX,Dust2,11,11,22,0.5
VERTEX,Inferno,29,12,41,0.7073170731707317
VERTEX,Mirage,18,15,33,0.5454545454545454
VERTEX,Nuke,18,18,36,0.5
VERTEX,Overpass,22,11,33,0.6666666666666666
VERTEX,Vertigo,31,11,42,0.7380952380952381
VGT,Dust2,0,1,1,0.0
VGT,Nuke,0,1,1,0.0
VISU,Mirage,0,1,1,0.0
VISU,Nuke,0,1,1,0.0
VISU,Overpass,0,1,1,0.0
VIXIT,Inferno,0,1,1,0.0
VIXIT,Overpass,0,1,1,0.0
VOID,Ancient,2,3,5,0.4
VOID,Dust2,0,1,1,0.0
VOID,Inferno,0,3,3,0.0
VOID,Mirage,0,3,3,0.0
VOID,Nuke,0,1,1,0.0
VOID,Overpass,1,0,1,1.0
VOID,Vertigo,1,1,2,0.5
VOYVODA,Ancient,5,0,5,1.0
VOYVODA,Anubis,3,3,6,0.5
VOYVODA,Inferno,8,0,8,1.0
VOYVODA,Mirage,12,1,13,0.9230769230769231
VOYVODA,Nuke,4,2,6,0.6666666666666666
VOYVODA,Overpass,5,0,5,1.0
VP.Prodigy,Ancient,9,11,20,0.45
VP.Prodigy,Dust2,2,12,14,0.14285714285714285
VP.Prodigy,Inferno,3,3,6,0.5
VP.Prodigy,Mirage,5,10,15,0.3333333333333333
VP.Prodigy,Nuke,4,9,13,0.3076923076923077
VP.Prodigy,Overpass,7,12,19,0.3684210526315789
VP.Prodigy,Vertigo,11,13,24,0.4583333333333333
VRTX,Inferno,0,1,1,0.0
Valence,Dust2,0,1,1,0.0
Valence,Mirage,0,1,1,0.0
Valence,Nuke,0,1,1,0.0
Valence,Vertigo,0,1,1,0.0
Valkyrie,Dust2,0,1,1,0.0
Valkyrie,Inferno,0,1,1,0.0
Valkyrie,Mirage,0,1,1,0.0
Valkyrie,Overpass,0,1,1,0.0
Valkyrie,Vertigo,1,0,1,1.0
Valkyries fe,Ancient,0,1,1,0.0
Valkyries fe,Dust2,0,1,1,0.0
Valors,Ancient,0,2,2,0.0
Valors,Dust2,3,0,3,1.0
Valors,Inferno,6,4,10,0.6
Valors,Mirage,8,3,11,0.7272727272727273
Valors,Nuke,5,6,11,0.45454545454545453
Valors,Overpass,6,3,9,0.6666666666666666
Valors,Vertigo,0,3,3,0.0
Valors2,Inferno,0,1,1,0.0
Valors2,Mirage,1,1,2,0.5
Vanir,Overpass,0,1,1,0.0
Vanir,Vertigo,0,1,1,0.0
Vdrxp,Inferno,0,1,1,0.0
Vdrxp,Overpass,0,1,1,0.0
Velez Mostar,Inferno,1,2,3,0.3333333333333333
Velez Mostar,Nuke,0,1,1,0.0
Velez Mostar,Overpass,1,0,1,1.0
Velez Mostar,Vertigo,0,1,1,0.0
Vendetta,Ancient,11,7,18,0.6111111111111112
Vendetta,Dust2,2,3,5,0.4
Vendetta,Inferno,7,8,15,0.4666666666666667
Vendetta,Mirage,14,14,28,0.5
Vendetta,Nuke,7,2,9,0.7777777777777778
Vendetta,Overpass,9,11,20,0.45
Vendetta,Vertigo,4,3,7,0.5714285714285714
Verum,Ancient,3,0,3,1.0
Verum,Dust2,0,1,1,0.0
Verum,Inferno,3,5,8,0.375
Verum,Mirage,5,4,9,0.5555555555555556
Verum,Nuke,7,6,13,0.5384615384615384
Verum,Overpass,1,1,2,0.5
Verum,Vertigo,2,4,6,0.3333333333333333
Vexo Purple,Ancient,0,1,1,0.0
Vexo Purple,Dust2,0,1,1,0.0
Vexo Purple,Inferno,1,3,4,0.25
Vexo Purple,Mirage,0,1,1,0.0
Vexo Purple,Nuke,1,2,3,0.3333333333333333
ViCi,Ancient,1,1,2,0.5
ViCi,Inferno,2,3,5,0.4
ViCi,Mirage,3,4,7,0.42857142857142855
ViCi,Nuke,7,0,7,1.0
ViCi,Overpass,2,1,3,0.6666666666666666
ViCi,Vertigo,1,1,2,0.5
Viary,Ancient,0,1,1,0.0
Viary,Dust2,0,1,1,0.0
Viary,Inferno,1,0,1,1.0
Viary,Mirage,0,1,1,0.0
Viary,Vertigo,0,1,1,0.0
Vicious Kitties,Ancient,0,1,1,0.0
Vicious Kitties,Overpass,0,1,1,0.0
Victorum,Ancient,7,6,13,0.5384615384615384
Victorum,Dust2,3,3,6,0.5
Victorum,Inferno,5,2,7,0.7142857142857143
Victorum,Mirage,3,12,15,0.2
Victorum,Nuke,8,8,16,0.5
Victorum,Overpass,0,4,4,0.0
Victorum,Vertigo,1,5,6,0.16666666666666666
Victus,Inferno,0,1,1,0.0
Victus,Vertigo,0,1,1,0.0
Vietnam,Ancient,0,1,1,0.0
Vietnam,Dust2,0,1,1,0.0
Vietnam,Inferno,0,1,1,0.0
Vietnam,Mirage,0,1,1,0.0
Vikings,Ancient,1,0,1,1.0
Vikings,Dust2,1,2,3,0.3333333333333333
Vikings,Mirage,2,1,3,0.6666666666666666
Vikings,Nuke,1,1,2,0.5
Vikings,Overpass,0,1,1,0.0
Villainous,Ancient,8,7,15,0.5333333333333333
Villainous,Anubis,0,2,2,0.0
Villainous,Dust2,4,6,10,0.4
Villainous,Inferno,12,21,33,0.36363636363636365
Villainous,Mirage,20,14,34,0.5882352941176471
Villainous,Nuke,7,10,17,0.4117647058823529
Villainous,Overpass,1,0,1,1.0
Villainous,Vertigo,11,8,19,0.5789473684210527
Viperio,Ancient,5,2,7,0.7142857142857143
Viperio,Anubis,3,5,8,0.375
Viperio,Dust2,1,0,1,1.0
Viperio,Inferno,1,4,5,0.2
Viperio,Mirage,1,1,2,0.5
Viperio,Nuke,9,4,13,0.6923076923076923
Viperio,Overpass,5,6,11,0.45454545454545453
Viperio,Vertigo,5,8,13,0.38461538461538464
Vireo.pro,Dust2,0,2,2,0.0
Vireo.pro,Inferno,2,2,4,0.5
Vireo.pro,Mirage,2,1,3,0.6666666666666666
Vireo.pro,Nuke,0,4,4,0.0
Vireo.pro,Overpass,1,0,1,1.0
Virtus.pro,Ancient,6,5,11,0.5454545454545454
Virtus.pro,Dust2,10,7,17,0.5882352941176471
Virtus.pro,Inferno,11,10,21,0.5238095238095238
Virtus.pro,Mirage,8,9,17,0.47058823529411764
Virtus.pro,Overpass,12,7,19,0.631578947368421
Virtus.pro,Vertigo,9,5,14,0.6428571428571429
Vision,Mirage,0,1,1,0.0
Vision,Overpass,0,1,1,0.0
Vitality,Anubis,0,1,1,0.0
Vitality,Dust2,27,16,43,0.627906976744186
Vitality,Inferno,32,25,57,0.5614035087719298
Vitality,Mirage,30,28,58,0.5172413793103449
Vitality,Nuke,26,19,45,0.5777777777777777
Vitality,Overpass,19,14,33,0.5757575757575758
Vitality,Vertigo,24,11,35,0.6857142857142857
Vladivostok,Ancient,2,1,3,0.6666666666666666
Vladivostok,Inferno,0,1,1,0.0
Vladivostok,Nuke,2,1,3,0.6666666666666666
Vladivostok,Overpass,0,1,1,0.0
Volted,Inferno,1,0,1,1.0
Volted,Mirage,0,2,2,0.0
Volted,Nuke,1,2,3,0.3333333333333333
Volted,Vertigo,0,1,1,0.0
W7M fe,Anubis,1,0,1,1.0
W7M fe,Dust2,0,1,1,0.0
W7M fe,Inferno,0,3,3,0.0
W7M fe,Mirage,0,5,5,0.0
WAP,Ancient,0,1,1,0.0
WAP,Inferno,0,2,2,0.0
WAP,Nuke,0,1,1,0.0
WAP,Vertigo,0,1,1,0.0
WDNMD,Dust2,1,1,2,0.5
WDNMD,Inferno,1,1,2,0.5
WDNMD,Nuke,1,0,1,1.0
WDNMD,Vertigo,0,2,2,0.0
WHYKICK,Ancient,0,1,1,0.0
WHYKICK,Overpass,0,1,1,0.0
WINDINGO,Ancient,5,7,12,0.4166666666666667
WINDINGO,Anubis,2,4,6,0.3333333333333333
WINDINGO,Dust2,6,10,16,0.375
WINDINGO,Inferno,3,5,8,0.375
WINDINGO,Mirage,8,6,14,0.5714285714285714
WINDINGO,Nuke,12,13,25,0.48
WINDINGO,Overpass,7,4,11,0.6363636363636364
WINDINGO Community,Mirage,1,0,1,1.0
WINDINGO Community,Nuke,0,1,1,0.0
WINDINGO Community,Overpass,1,1,2,0.5
WLG,Ancient,0,2,2,0.0
WLG,Inferno,1,3,4,0.25
WLG,Mirage,0,4,4,0.0
WORTEX,Dust2,0,2,2,0.0
WORTEX,Inferno,1,1,2,0.5
WORTEX,Mirage,0,1,1,0.0
WOWMEGA,Inferno,0,1,1,0.0
WOWMEGA,Nuke,0,1,1,0.0
WahWah,Mirage,0,1,1,0.0
Wales,Mirage,0,1,1,0.0
Wales,Overpass,0,1,1,0.0
Warriors,Ancient,0,1,1,0.0
Warriors,Dust2,3,9,12,0.25
Warriors,Inferno,3,2,5,0.6
Warriors,Mirage,6,3,9,0.6666666666666666
Warriors,Nuke,2,3,5,0.4
Warriors,Overpass,0,2,2,0.0
Warriors,Vertigo,0,2,2,0.0
Way2Game,Mirage,0,1,1,0.0
Way2Game,Overpass,0,1,1,0.0
We Global,Mirage,0,1,1,0.0
Websterz,Ancient,0,1,1,0.0
Websterz,Anubis,4,4,8,0.5
Websterz,Dust2,4,9,13,0.3076923076923077
Websterz,Inferno,11,15,26,0.4230769230769231
Websterz,Mirage,12,10,22,0.5454545454545454
Websterz,Nuke,10,7,17,0.5882352941176471
Websterz,Overpass,3,15,18,0.16666666666666666
Websterz,Vertigo,5,5,10,0.5
WetKillers,Dust2,1,0,1,1.0
WetKillers,Nuke,0,1,1,0.0
WetKillers,Vertigo,1,0,1,1.0
White Rabbit,Inferno,0,1,1,0.0
White Rabbit,Mirage,0,1,1,0.0
WinX,Ancient,0,1,1,0.0
WinX,Dust2,2,1,3,0.6666666666666666
WinX,Inferno,0,2,2,0.0
WinX,Mirage,1,2,3,0.3333333333333333
WinX,Overpass,0,2,2,0.0
Wings Up,Ancient,5,9,14,0.35714285714285715
Wings Up,Anubis,0,1,1,0.0
Wings Up,Dust2,7,6,13,0.5384615384615384
Wings Up,Inferno,18,18,36,0.5
Wings Up,Mirage,14,4,18,0.7777777777777778
Wings Up,Nuke,11,11,22,0.5
Wings Up,Overpass,1,10,11,0.09090909090909091
Wings Up,Vertigo,0,1,1,0.0
Wisla Krakow,Ancient,16,18,34,0.47058823529411764
Wisla Krakow,Dust2,14,17,31,0.45161290322580644
Wisla Krakow,Inferno,15,19,34,0.4411764705882353
Wisla Krakow,Mirage,14,22,36,0.3888888888888889
Wisla Krakow,Nuke,27,20,47,0.574468085106383
Wisla Krakow,Overpass,29,23,52,0.5576923076923077
Wisla Krakow,Vertigo,2,5,7,0.2857142857142857
Wizard,Dust2,2,0,2,1.0
Wizard,Nuke,1,0,1,1.0
Wizard,Overpass,0,1,1,0.0
Wizard,Vertigo,0,1,1,0.0
Wolsung,Ancient,1,5,6,0.16666666666666666
Wolsung,Dust2,6,4,10,0.6
Wolsung,Inferno,5,10,15,0.3333333333333333
Wolsung,Mirage,4,6,10,0.4
Wolsung,Nuke,3,3,6,0.5
Wolsung,Overpass,4,6,10,0.4
WonderKids,Dust2,0,1,1,0.0
WonderKids,Inferno,0,1,1,0.0
WonderKids,Mirage,0,1,1,0.0
WonderKids,Nuke,0,1,1,0.0
Wygers AR,Dust2,1,4,5,0.2
Wygers AR,Inferno,1,1,2,0.5
Wygers AR,Nuke,0,6,6,0.0
Wygers AR,Overpass,0,2,2,0.0
X,Ancient,6,2,8,0.75
X,Dust2,5,8,13,0.38461538461538464
X,Inferno,11,9,20,0.55
X,Mirage,2,8,10,0.2
X,Nuke,1,2,3,0.3333333333333333
X,Overpass,2,1,3,0.6666666666666666
X,Vertigo,3,6,9,0.3333333333333333
X Gamer,Ancient,0,1,1,0.0
X Gamer,Dust2,1,1,2,0.5
X Gamer,Inferno,6,7,13,0.46153846153846156
X Gamer,Mirage,5,3,8,0.625
X Gamer,Nuke,0,4,4,0.0
X Gamer,Overpass,3,4,7,0.42857142857142855
X Gamer,Vertigo,1,0,1,1.0
X13,Ancient,7,12,19,0.3684210526315789
X13,Dust2,4,6,10,0.4
X13,Inferno,11,17,28,0.39285714285714285
X13,Mirage,6,4,10,0.6
X13,Nuke,10,16,26,0.38461538461538464
X13,Overpass,8,14,22,0.36363636363636365
X13,Vertigo,8,10,18,0.4444444444444444
XGC,Dust2,1,1,2,0.5
XGC,Inferno,1,0,1,1.0
XGC,Mirage,0,3,3,0.0
XGC,Overpass,0,1,1,0.0
XGC,Vertigo,0,2,2,0.0
XIS,Dust2,0,1,1,0.0
XP,Ancient,0,1,1,0.0
XP,Inferno,0,1,1,0.0
XP,Mirage,1,0,1,1.0
XP,Vertigo,0,1,1,0.0
XRAVEL,Ancient,0,1,1,0.0
XRAVEL,Overpass,0,1,1,0.0
XXG,Inferno,0,1,1,0.0
YK,Ancient,2,3,5,0.4
YK,Inferno,9,8,17,0.5294117647058824
YK,Mirage,4,5,9,0.4444444444444444
YK,Nuke,4,7,11,0.36363636363636365
YK,Overpass,3,1,4,0.75
YK,Vertigo,2,0,2,1.0
Yawara,Ancient,0,1,1,0.0
Yawara,Dust2,0,1,1,0.0
Yawara,Inferno,0,1,1,0.0
Yawara,Mirage,0,2,2,0.0
Yawara,Vertigo,1,1,2,0.5
YeniCherry,Ancient,0,1,1,0.0
YeniCherry,Dust2,1,3,4,0.25
YeniCherry,Inferno,3,3,6,0.5
YeniCherry,Mirage,0,1,1,0.0
YeniCherry,Nuke,1,3,4,0.25
YeniCherry,Overpass,2,1,3,0.6666666666666666
YeniCherry,Vertigo,1,2,3,0.3333333333333333
Yimagen,Ancient,1,0,1,1.0
Yimagen,Dust2,0,1,1,0.0
Yimagen,Mirage,1,0,1,1.0
Yimagen,Nuke,1,0,1,1.0
Yimagen,Vertigo,0,1,1,0.0
You Shall Not Pass,Anubis,1,0,1,1.0
You Shall Not Pass,Train,1,0,1,1.0
You Shall Not Pass,Tuscan,1,0,1,1.0
Young Gods,Ancient,4,2,6,0.6666666666666666
Young Gods,Dust2,1,2,3,0.3333333333333333
Young Gods,Inferno,1,2,3,0.3333333333333333
Young Gods,Mirage,5,4,9,0.5555555555555556
Young Gods,Overpass,0,3,3,0.0
Young Gods,Vertigo,2,2,4,0.5
Young Ninjas,Ancient,15,12,27,0.5555555555555556
Young Ninjas,Dust2,6,7,13,0.46153846153846156
Young Ninjas,Inferno,45,32,77,0.5844155844155844
Young Ninjas,Mirage,36,39,75,0.48
Young Ninjas,Nuke,15,25,40,0.375
Young Ninjas,Overpass,42,30,72,0.5833333333333334
Young Ninjas,Vertigo,33,20,53,0.6226415094339622
ZEROZONE,Inferno,0,1,1,0.0
ZEROZONE,Nuke,0,1,1,0.0
ZIGMA,Dust2,0,1,1,0.0
ZIGMA,Inferno,0,1,1,0.0
ZURIA,Ancient,0,2,2,0.0
ZURIA,Inferno,0,3,3,0.0
ZURIA,Mirage,1,1,2,0.5
ZURIA,Overpass,1,1,2,0.5
Zenigma,Ancient,1,0,1,1.0
Zenigma,Dust2,0,1,1,0.0
Zenigma,Mirage,1,0,1,1.0
Zenigma,Vertigo,0,1,1,0.0
Zero MarksMen,Inferno,0,1,1,0.0
Zero MarksMen,Nuke,0,2,2,0.0
Zero MarksMen,Overpass,0,1,1,0.0
Zero Tenacity,Ancient,0,2,2,0.0
Zero Tenacity,Anubis,1,2,3,0.3333333333333333
Zero Tenacity,Dust2,5,4,9,0.5555555555555556
Zero Tenacity,Inferno,5,16,21,0.23809523809523808
Zero Tenacity,Mirage,9,15,24,0.375
Zero Tenacity,Nuke,7,7,14,0.5
Zero Tenacity,Overpass,3,5,8,0.375
Zero Tenacity,Vertigo,4,3,7,0.5714285714285714
Zorka,Mirage,1,0,1,1.0
Zorka,Nuke,1,0,1,1.0
Zorka,Vertigo,0,1,1,0.0
aktiebolag,Ancient,1,0,1,1.0
aktiebolag,Anubis,1,0,1,1.0
aktiebolag,Inferno,1,0,1,1.0
aktiebolag,Mirage,0,2,2,0.0
aktiebolag,Overpass,0,1,1,0.0
all aim no name,Mirage,2,1,3,0.6666666666666666
all aim no name,Nuke,2,1,3,0.6666666666666666
all aim no name,Vertigo,0,1,1,0.0
allStars,Ancient,3,2,5,0.6
allStars,Anubis,0,1,1,0.0
allStars,Dust2,2,8,10,0.2
allStars,Inferno,2,7,9,0.2222222222222222
allStars,Mirage,5,8,13,0.38461538461538464
allStars,Nuke,0,3,3,0.0
allStars,Overpass,2,4,6,0.3333333333333333
allStars,Vertigo,2,1,3,0.6666666666666666
askars,Ancient,0,1,1,0.0
askars,Dust2,1,0,1,1.0
askars,Inferno,1,1,2,0.5
askars,Overpass,0,1,1,0.0
bait 4 it,Mirage,0,1,1,0.0
bait 4 it,Overpass,0,1,1,0.0
bankaPEPSI,Ancient,6,4,10,0.6
bankaPEPSI,Dust2,10,7,17,0.5882352941176471
bankaPEPSI,Inferno,2,8,10,0.2
bankaPEPSI,Mirage,1,4,5,0.2
bankaPEPSI,Nuke,4,8,12,0.3333333333333333
bankaPEPSI,Overpass,2,2,4,0.5
benched,Inferno,1,1,2,0.5
benched,Nuke,0,2,2,0.0
benched,Overpass,0,1,1,0.0
blacklaminate,Dust2,0,2,2,0.0
blacklaminate,Inferno,0,2,2,0.0
blacklaminate,Mirage,1,1,2,0.5
blacklaminate,Nuke,1,0,1,1.0
blacklaminate,Vertigo,0,1,1,0.0
blingus,Ancient,1,1,2,0.5
blingus,Inferno,0,1,1,0.0
blingus,Mirage,1,0,1,1.0
blingus,Nuke,1,0,1,1.0
blingus,Overpass,0,2,2,0.0
blingus,Vertigo,0,1,1,0.0
boomer demons,Nuke,0,1,1,0.0
bosses,Ancient,0,1,1,0.0
bosses,Dust2,1,0,1,1.0
bosses,Inferno,1,0,1,1.0
bosses,Mirage,1,1,2,0.5
bosses,Nuke,2,0,2,1.0
bosses,Overpass,2,0,2,1.0
boyfriend peek,Dust2,0,1,1,0.0
boyfriend peek,Inferno,0,2,2,0.0
boyfriend peek,Mirage,2,2,4,0.5
boyfriend peek,Overpass,2,1,3,0.6666666666666666
caffeine marauders,Inferno,2,0,2,1.0
caffeine marauders,Mirage,1,1,2,0.5
caffeine marauders,Vertigo,0,1,1,0.0
coconutwater,Ancient,1,0,1,1.0
coconutwater,Inferno,1,0,1,1.0
coluant,Ancient,0,1,1,0.0
coluant,Dust2,0,1,1,0.0
coluant,Inferno,1,0,1,1.0
coluant,Mirage,0,3,3,0.0
coluant,Nuke,0,2,2,0.0
coluant,Vertigo,0,1,1,0.0
cowana,Ancient,7,6,13,0.5384615384615384
cowana,Dust2,10,9,19,0.5263157894736842
cowana,Inferno,13,7,20,0.65
cowana,Mirage,1,6,7,0.14285714285714285
cowana,Nuke,4,3,7,0.5714285714285714
cowana,Overpass,6,9,15,0.4
cowana,Vertigo,7,12,19,0.3684210526315789
cs,Nuke,0,1,1,0.0
cu fish,Ancient,0,1,1,0.0
cu fish,Anubis,0,1,1,0.0
cu fish,Inferno,0,1,1,0.0
cu fish,Mirage,1,0,1,1.0
cu fish,Overpass,0,1,1,0.0
d54,Dust2,0,1,1,0.0
dobrywieczor,Nuke,0,1,1,0.0
dobrywieczor,Overpass,1,0,1,1.0
dobrywieczor,Vertigo,0,1,1,0.0
domilk,Ancient,0,4,4,0.0
domilk,Inferno,0,1,1,0.0
domilk,Mirage,0,5,5,0.0
domilk,Nuke,1,3,4,0.25
domilk,Overpass,1,2,3,0.3333333333333333
domilk,Vertigo,0,2,2,0.0
ducksquad,Overpass,0,1,1,0.0
duncans & dragons,Nuke,0,1,1,0.0
e-LEMON-ators,Dust2,1,0,1,1.0
e-LEMON-ators,Inferno,1,0,1,1.0
e-LEMON-ators,Mirage,1,0,1,1.0
e-LEMON-ators,Nuke,2,1,3,0.6666666666666666
e-LEMON-ators,Overpass,0,3,3,0.0
e-LEMON-ators,Vertigo,1,3,4,0.25
eMasters,Ancient,2,1,3,0.6666666666666666
eMasters,Inferno,0,1,1,0.0
eMasters,Nuke,3,0,3,1.0
eMasters,Overpass,0,1,1,0.0
eMasters,Vertigo,0,1,1,0.0
eRa,Nuke,0,1,1,0.0
eRa,Vertigo,0,1,1,0.0
eSuba,Ancient,9,15,24,0.375
eSuba,Dust2,1,2,3,0.3333333333333333
eSuba,Inferno,12,23,35,0.34285714285714286
eSuba,Mirage,27,27,54,0.5
eSuba,Nuke,18,26,44,0.4090909090909091
eSuba,Overpass,13,13,26,0.5
eSuba,Vertigo,16,17,33,0.48484848484848486
eXploit,Ancient,5,5,10,0.5
eXploit,Dust2,5,5,10,0.5
eXploit,Inferno,6,6,12,0.5
eXploit,Mirage,0,2,2,0.0
eXploit,Nuke,3,3,6,0.5
eXploit,Vertigo,3,1,4,0.75
eetswa,Inferno,0,1,1,0.0
eetswa,Mirage,1,0,1,1.0
eetswa,Nuke,0,1,1,0.0
eetswa,Overpass,0,1,1,0.0
equipa,Ancient,1,0,1,1.0
equipa,Inferno,2,0,2,1.0
equipa,Nuke,0,2,2,0.0
equipa,Overpass,2,0,2,1.0
equipa,Vertigo,1,0,1,1.0
ex-100PG,Dust2,1,1,2,0.5
ex-100PG,Inferno,1,0,1,1.0
ex-100PG,Mirage,0,2,2,0.0
ex-100PG,Overpass,0,2,2,0.0
ex-100PG,Vertigo,0,1,1,0.0
ex-4glory,Ancient,1,0,1,1.0
ex-4glory,Dust2,1,0,1,1.0
ex-4glory,Inferno,0,1,1,0.0
ex-4glory,Mirage,2,0,2,1.0
ex-4glory,Nuke,1,0,1,1.0
ex-4glory,Vertigo,2,1,3,0.6666666666666666
ex-AGF,Mirage,0,1,1,0.0
ex-AGF,Nuke,0,1,1,0.0
ex-AGF,Vertigo,1,0,1,1.0
ex-Akuma,Dust2,1,0,1,1.0
ex-Akuma,Inferno,1,0,1,1.0
ex-B4,Ancient,1,0,1,1.0
ex-B4,Inferno,0,1,1,0.0
ex-B4,Mirage,0,1,1,0.0
ex-Bizarre,Ancient,1,0,1,1.0
ex-Bizarre,Dust2,1,0,1,1.0
ex-Bizarre,Inferno,1,0,1,1.0
ex-Bizarre,Mirage,0,1,1,0.0
ex-Bizarre,Nuke,0,1,1,0.0
ex-Black Dragons,Ancient,1,1,2,0.5
ex-Black Dragons,Dust2,2,1,3,0.6666666666666666
ex-Black Dragons,Inferno,0,2,2,0.0
ex-Black Dragons,Mirage,0,3,3,0.0
ex-Black Dragons,Nuke,2,2,4,0.5
ex-Black Dragons,Overpass,1,0,1,1.0
ex-Black Dragons fe,Dust2,1,0,1,1.0
ex-Black Dragons fe,Mirage,1,0,1,1.0
ex-CLEANTmix,Inferno,0,1,1,0.0
ex-CLEANTmix,Mirage,0,1,1,0.0
ex-CearГЎ,Ancient,2,0,2,1.0
ex-CearГЎ,Dust2,2,1,3,0.6666666666666666
ex-CearГЎ,Inferno,2,1,3,0.6666666666666666
ex-CearГЎ,Mirage,1,2,3,0.3333333333333333
ex-CearГЎ,Nuke,2,4,6,0.3333333333333333
ex-CearГЎ,Overpass,0,1,1,0.0
ex-CearГЎ,Vertigo,2,0,2,1.0
ex-Coalesce,Ancient,0,1,1,0.0
ex-Coalesce,Inferno,0,1,1,0.0
ex-Coalesce,Mirage,1,0,1,1.0
ex-Coalesce,Nuke,0,1,1,0.0
ex-Coalesce,Overpass,1,0,1,1.0
ex-Daotsu,Inferno,1,0,1,1.0
ex-Daotsu,Mirage,0,1,1,0.0
ex-Daotsu,Nuke,1,1,2,0.5
ex-Daotsu,Overpass,2,1,3,0.6666666666666666
ex-Durany,Dust2,2,3,5,0.4
ex-Durany,Inferno,1,4,5,0.2
ex-Durany,Mirage,0,1,1,0.0
ex-Durany,Nuke,3,4,7,0.42857142857142855
ex-FURY,Ancient,3,3,6,0.5
ex-FURY,Dust2,0,1,1,0.0
ex-FURY,Inferno,2,7,9,0.2222222222222222
ex-FURY,Mirage,1,2,3,0.3333333333333333
ex-FURY,Nuke,4,7,11,0.36363636363636365
ex-FURY,Overpass,2,3,5,0.4
ex-Feenix,Inferno,0,1,1,0.0
ex-Feenix,Vertigo,0,1,1,0.0
ex-Finest,Ancient,7,7,14,0.5
ex-Finest,Dust2,9,5,14,0.6428571428571429
ex-Finest,Inferno,5,3,8,0.625
ex-Finest,Mirage,2,4,6,0.3333333333333333
ex-Finest,Nuke,0,2,2,0.0
ex-Finest,Overpass,6,4,10,0.6
ex-Finest,Vertigo,6,8,14,0.42857142857142855
ex-Holkattes,Dust2,2,1,3,0.6666666666666666
ex-Holkattes,Inferno,3,2,5,0.6
ex-Holkattes,Mirage,1,1,2,0.5
ex-Holkattes,Nuke,2,2,4,0.5
ex-Holkattes,Overpass,0,2,2,0.0
ex-Imperial,Nuke,0,1,1,0.0
ex-Into the Breach,Ancient,1,1,2,0.5
ex-Into the Breach,Dust2,2,0,2,1.0
ex-Into the Breach,Inferno,2,2,4,0.5
ex-Into the Breach,Mirage,1,0,1,1.0
ex-Into the Breach,Nuke,1,1,2,0.5
ex-Into the Breach,Overpass,3,2,5,0.6
ex-Isurus,Ancient,0,1,1,0.0
ex-KG Network,Ancient,1,1,2,0.5
ex-KG Network,Dust2,0,1,1,0.0
ex-KG Network,Inferno,0,1,1,0.0
ex-KG Network,Mirage,0,1,1,0.0
ex-KG Network,Nuke,2,2,4,0.5
ex-KG Network,Vertigo,0,1,1,0.0
ex-Lese,Dust2,0,1,1,0.0
ex-Lese,Inferno,0,1,1,0.0
ex-Lese,Nuke,0,2,2,0.0
ex-MAD Lions,Ancient,6,5,11,0.5454545454545454
ex-MAD Lions,Dust2,4,2,6,0.6666666666666666
ex-MAD Lions,Inferno,6,3,9,0.6666666666666666
ex-MAD Lions,Mirage,9,4,13,0.6923076923076923
ex-MAD Lions,Nuke,5,2,7,0.7142857142857143
ex-MAD Lions,Overpass,1,2,3,0.3333333333333333
ex-MAD Lions,Vertigo,1,1,2,0.5
ex-Marlian,Ancient,2,1,3,0.6666666666666666
ex-Marlian,Dust2,0,2,2,0.0
ex-Marlian,Mirage,1,1,2,0.5
ex-Marlian,Nuke,1,3,4,0.25
ex-Marlian,Overpass,1,2,3,0.3333333333333333
ex-Marlian,Vertigo,1,3,4,0.25
ex-PR Stars,Ancient,2,0,2,1.0
ex-PR Stars,Dust2,2,1,3,0.6666666666666666
ex-PR Stars,Inferno,0,2,2,0.0
ex-PR Stars,Nuke,3,2,5,0.6
ex-PR Stars,Overpass,0,1,1,0.0
ex-PR Stars,Vertigo,0,1,1,0.0
ex-Philadelphia Liberty,Mirage,0,1,1,0.0
ex-Philadelphia Liberty,Vertigo,0,1,1,0.0
ex-Pompa,Dust2,0,1,1,0.0
ex-Pompa,Overpass,0,1,1,0.0
ex-Project Eversio,Ancient,0,1,1,0.0
ex-Project Eversio,Dust2,0,1,1,0.0
ex-Project Eversio,Inferno,0,1,1,0.0
ex-Project Eversio,Mirage,0,1,1,0.0
ex-Project Eversio,Nuke,2,1,3,0.6666666666666666
ex-Project Eversio,Overpass,1,0,1,1.0
ex-Quantum Bellator Fire,Ancient,1,0,1,1.0
ex-Quantum Bellator Fire,Inferno,0,2,2,0.0
ex-Quantum Bellator Fire,Mirage,1,0,1,1.0
ex-Quantum Bellator Fire,Overpass,1,0,1,1.0
ex-Quantum Bellator Fire,Vertigo,0,4,4,0.0
ex-Rapid Ninjas,Anubis,0,1,1,0.0
ex-Rapid Ninjas,Inferno,0,1,1,0.0
ex-Rapid Ninjas,Mirage,1,0,1,1.0
ex-SG,Dust2,1,0,1,1.0
ex-SG,Inferno,1,1,2,0.5
ex-SG,Mirage,0,1,1,0.0
ex-SKADE,Ancient,2,6,8,0.25
ex-SKADE,Dust2,2,3,5,0.4
ex-SKADE,Inferno,10,5,15,0.6666666666666666
ex-SKADE,Mirage,3,2,5,0.6
ex-SKADE,Nuke,4,6,10,0.4
ex-SKADE,Overpass,6,4,10,0.6
ex-TAG,Mirage,0,1,1,0.0
ex-TAG,Nuke,1,0,1,1.0
ex-TAG,Overpass,0,1,1,0.0
ex-TITANS,Ancient,0,1,1,0.0
ex-TITANS,Dust2,1,1,2,0.5
ex-TITANS,Inferno,1,0,1,1.0
ex-TITANS,Mirage,0,2,2,0.0
ex-TITANS,Nuke,0,1,1,0.0
ex-TITANS,Overpass,0,2,2,0.0
ex-UYU,Dust2,0,2,2,0.0
ex-UYU,Inferno,1,5,6,0.16666666666666666
ex-UYU,Mirage,1,3,4,0.25
ex-UYU,Nuke,0,4,4,0.0
ex-UYU,Overpass,0,1,1,0.0
ex-UYU,Vertigo,1,0,1,1.0
ex-Young Gods,Dust2,1,0,1,1.0
ex-Young Gods,Mirage,1,0,1,1.0
fANDER,Dust2,0,2,2,0.0
fANDER,Inferno,1,0,1,1.0
fANDER,Mirage,0,2,2,0.0
farfaraway,Inferno,0,1,1,0.0
farfaraway,Mirage,0,1,1,0.0
farfaraway,Nuke,0,1,1,0.0
feA,Ancient,0,1,1,0.0
fightclub,Ancient,1,0,1,1.0
fightclub,Inferno,0,1,1,0.0
fightclub,Mirage,2,0,2,1.0
fightclub,Overpass,1,0,1,1.0
fightclub,Vertigo,1,0,1,1.0
fl0m's Money Crew,Overpass,0,2,2,0.0
flowstate,Overpass,0,2,2,0.0
fnatic,Ancient,15,10,25,0.6
fnatic,Anubis,0,1,1,0.0
fnatic,Dust2,2,5,7,0.2857142857142857
fnatic,Inferno,29,20,49,0.5918367346938775
fnatic,Mirage,21,24,45,0.4666666666666667
fnatic,Nuke,30,15,45,0.6666666666666666
fnatic,Overpass,34,19,53,0.6415094339622641
fnatic,Vertigo,14,11,25,0.56
fnatic Rising,Ancient,15,17,32,0.46875
fnatic Rising,Dust2,5,2,7,0.7142857142857143
fnatic Rising,Inferno,32,21,53,0.6037735849056604
fnatic Rising,Mirage,10,9,19,0.5263157894736842
fnatic Rising,Nuke,7,12,19,0.3684210526315789
fnatic Rising,Overpass,18,12,30,0.6
fnatic Rising,Vertigo,29,24,53,0.5471698113207547
fullshock,Dust2,1,0,1,1.0
fullshock,Mirage,0,1,1,0.0
fullshock,Nuke,0,1,1,0.0
fullshock,Overpass,0,1,1,0.0
fullshock,Vertigo,0,1,1,0.0
gamers innit,Dust2,2,0,2,1.0
gamers innit,Inferno,0,2,2,0.0
gamers innit,Nuke,0,1,1,0.0
gamers innit,Vertigo,0,1,1,0.0
garTi,Ancient,0,2,2,0.0
garTi,Mirage,1,1,2,0.5
garTi,Vertigo,1,1,2,0.5
gg go next qualy,Inferno,0,1,1,0.0
gold medalists,Dust2,1,0,1,1.0
gold medalists,Inferno,1,1,2,0.5
gold medalists,Mirage,1,0,1,1.0
gold medalists,Vertigo,0,1,1,0.0
gothboiclique,Ancient,1,2,3,0.3333333333333333
gothboiclique,Dust2,1,4,5,0.2
gothboiclique,Inferno,1,1,2,0.5
gothboiclique,Mirage,1,0,1,1.0
gothboiclique,Nuke,1,0,1,1.0
gothboiclique,Overpass,0,2,2,0.0
gothboiclique,Vertigo,0,1,1,0.0
hREDS,Ancient,4,10,14,0.2857142857142857
hREDS,Dust2,1,1,2,0.5
hREDS,Inferno,11,14,25,0.44
hREDS,Mirage,0,5,5,0.0
hREDS,Nuke,10,8,18,0.5555555555555556
hREDS,Overpass,3,12,15,0.2
hREDS,Vertigo,3,3,6,0.5
homeless,Ancient,0,1,1,0.0
homeless,Inferno,0,1,1,0.0
homeless,Mirage,0,1,1,0.0
homeless,Overpass,0,1,1,0.0
homeless,Vertigo,1,0,1,1.0
how bad u are,Mirage,0,1,1,0.0
hxh,Mirage,0,1,1,0.0
hxh,Overpass,0,1,1,0.0
iDestructive,Ancient,0,1,1,0.0
iDestructive,Inferno,0,1,1,0.0
iNation,Ancient,15,12,27,0.5555555555555556
iNation,Anubis,8,3,11,0.7272727272727273
iNation,Dust2,3,9,12,0.25
iNation,Inferno,32,10,42,0.7619047619047619
iNation,Mirage,0,10,10,0.0
iNation,Nuke,15,8,23,0.6521739130434783
iNation,Overpass,9,6,15,0.6
iNation,Vertigo,8,10,18,0.4444444444444444
k1ck,Ancient,2,0,2,1.0
k1ck,Dust2,0,1,1,0.0
k1ck,Inferno,0,1,1,0.0
k1ck,Mirage,0,1,1,0.0
k1ck,Overpass,0,1,1,0.0
kebabs,Dust2,1,1,2,0.5
kebabs,Nuke,0,1,1,0.0
kennyS' Team,Dust2,1,0,1,1.0
kennyS' Team,Inferno,0,1,1,0.0
kennyS' Team,Nuke,2,1,3,0.6666666666666666
kennyS' Team,Overpass,0,1,1,0.0
kennyS' Team,Vertigo,0,1,1,0.0
kevlarirl,Ancient,1,1,2,0.5
kevlarirl,Mirage,0,1,1,0.0
kevlarirl,Overpass,2,0,2,1.0
kolibri,Inferno,0,1,1,0.0
kolibri,Mirage,0,1,1,0.0
kukkosoosi,Ancient,0,1,1,0.0
kukkosoosi,Mirage,0,1,1,0.0
laMafia,Mirage,0,1,1,0.0
lol123,Ancient,1,0,1,1.0
lol123,Dust2,0,2,2,0.0
lol123,Inferno,2,0,2,1.0
lol123,Mirage,4,2,6,0.6666666666666666
lol123,Nuke,3,3,6,0.5
lol123,Overpass,1,2,3,0.3333333333333333
loloNaMente,Ancient,0,1,1,0.0
loloNaMente,Inferno,0,1,1,0.0
loloNaMente,Nuke,0,1,1,0.0
los kogutos,Ancient,15,13,28,0.5357142857142857
los kogutos,Anubis,0,3,3,0.0
los kogutos,Dust2,5,9,14,0.35714285714285715
los kogutos,Inferno,0,2,2,0.0
los kogutos,Mirage,19,16,35,0.5428571428571428
los kogutos,Nuke,14,14,28,0.5
los kogutos,Overpass,8,10,18,0.4444444444444444
los kogutos,Vertigo,9,8,17,0.5294117647058824
mYinsanity,Dust2,3,2,5,0.6
mYinsanity,Inferno,1,5,6,0.16666666666666666
mYinsanity,Mirage,0,1,1,0.0
mYinsanity,Nuke,1,3,4,0.25
mYinsanity,Overpass,1,2,3,0.3333333333333333
maGic,Inferno,0,1,1,0.0
makuraSOFT,Ancient,1,0,1,1.0
makuraSOFT,Mirage,0,1,1,0.0
makuraSOFT,Vertigo,0,1,1,0.0
markeloff's Team,Dust2,0,1,1,0.0
markeloff's Team,Inferno,0,1,1,0.0
markeloff's Team,Mirage,0,1,1,0.0
maxed out,Inferno,0,1,1,0.0
mew,Ancient,0,1,1,0.0
mew,Dust2,0,1,1,0.0
mew,Mirage,0,1,1,0.0
mew,Overpass,0,1,1,0.0
mew,Vertigo,0,2,2,0.0
minion bobs,Inferno,0,1,1,0.0
minion bobs,Mirage,0,1,1,0.0
minion bobs,Nuke,0,1,1,0.0
minion bobs,Overpass,0,1,1,0.0
mix123,Anubis,0,1,1,0.0
mix123,Overpass,0,1,1,0.0
myllysuola,Mirage,0,1,1,0.0
myllysuola,Nuke,0,1,1,0.0
myllysuola,Vertigo,1,0,1,1.0
no meat pls,Inferno,1,0,1,1.0
no meat pls,Mirage,1,0,1,1.0
nomix,Anubis,0,1,1,0.0
nomix,Inferno,1,1,2,0.5
nomix,Mirage,1,2,3,0.3333333333333333
nomix,Overpass,2,1,3,0.6666666666666666
nomix,Vertigo,0,1,1,0.0
okura,Ancient,1,5,6,0.16666666666666666
okura,Dust2,0,2,2,0.0
okura,Mirage,2,4,6,0.3333333333333333
okura,Nuke,4,5,9,0.4444444444444444
okura,Overpass,1,1,2,0.5
okura,Vertigo,1,3,4,0.25
onLiNeRsX,Ancient,1,1,2,0.5
onLiNeRsX,Overpass,1,0,1,1.0
onLiNeRsX,Vertigo,0,1,1,0.0
ouroboros,Ancient,0,1,1,0.0
ouroboros,Mirage,1,1,2,0.5
ouroboros,Nuke,1,0,1,1.0
ouroboros,Overpass,0,1,1,0.0
ouroboros,Vertigo,1,0,1,1.0
ozbonz,Dust2,0,3,3,0.0
ozbonz,Inferno,1,0,1,1.0
ozbonz,Mirage,1,1,2,0.5
paiN,Ancient,30,17,47,0.6382978723404256
paiN,Anubis,2,1,3,0.6666666666666666
paiN,Dust2,33,6,39,0.8461538461538461
paiN,Inferno,27,26,53,0.5094339622641509
paiN,Mirage,11,10,21,0.5238095238095238
paiN,Nuke,67,21,88,0.7613636363636364
paiN,Overpass,19,15,34,0.5588235294117647
paiN,Vertigo,34,21,55,0.6181818181818182
paiN Academy,Ancient,1,1,2,0.5
paiN Academy,Nuke,1,0,1,1.0
pashaBiceps' Team,Dust2,0,1,1,0.0
pashaBiceps' Team,Inferno,0,1,1,0.0
pashaBiceps' Team,Mirage,1,1,2,0.5
pashaBiceps' Team,Nuke,0,1,1,0.0
premghouls,Ancient,0,1,1,0.0
premghouls,Overpass,0,3,3,0.0
proWince,Ancient,0,1,1,0.0
proWince,Inferno,1,1,2,0.5
proWince,Mirage,0,2,2,0.0
proxy,Ancient,0,1,1,0.0
proxy,Dust2,1,0,1,1.0
proxy,Mirage,1,1,2,0.5
proxy,Overpass,0,2,2,0.0
redditors,Overpass,0,1,1,0.0
sYnck,Ancient,0,1,1,0.0
sYnck,Anubis,1,1,2,0.5
sYnck,Inferno,0,3,3,0.0
sYnck,Mirage,2,2,4,0.5
sYnck,Overpass,0,2,2,0.0
sYnck,Vertigo,3,1,4,0.75
schadE halt,Ancient,2,1,3,0.6666666666666666
schadE halt,Inferno,1,3,4,0.25
schadE halt,Mirage,1,2,3,0.3333333333333333
schadE halt,Overpass,2,3,5,0.4
schadE halt,Vertigo,0,1,1,0.0
sftsaftm,Mirage,1,0,1,1.0
sftsaftm,Nuke,1,0,1,1.0
sftsaftm,Overpass,2,0,2,1.0
sftsaftm,Vertigo,0,1,1,0.0
sinister,Inferno,0,1,1,0.0
skeletor,Mirage,1,1,2,0.5
skeletor,Overpass,0,1,1,0.0
skriptovie,Mirage,0,1,1,0.0
skriptovie,Nuke,0,1,1,0.0
stinky big,Nuke,0,1,1,0.0
struggletony,Dust2,0,1,1,0.0
struggletony,Inferno,1,1,2,0.5
struggletony,Nuke,0,2,2,0.0
struggletony,Overpass,2,1,3,0.6666666666666666
struggletony,Vertigo,1,1,2,0.5
suxeN,Inferno,0,1,1,0.0
suxeN,Mirage,0,1,1,0.0
temp,Ancient,1,1,2,0.5
temp,Inferno,1,0,1,1.0
temp,Mirage,1,1,2,0.5
temp,Nuke,1,1,2,0.5
temp,Overpass,0,1,1,0.0
the jungle,Inferno,0,2,2,0.0
the jungle,Nuke,1,2,3,0.3333333333333333
timbermen,Ancient,4,6,10,0.4
timbermen,Dust2,0,1,1,0.0
timbermen,Inferno,4,4,8,0.5
timbermen,Mirage,10,9,19,0.5263157894736842
timbermen,Nuke,3,2,5,0.6
timbermen,Overpass,9,6,15,0.6
timbermen,Vertigo,3,5,8,0.375
tokyoxd,Inferno,0,1,1,0.0
tokyoxd,Mirage,2,3,5,0.4
tokyoxd,Nuke,1,1,2,0.5
tokyoxd,Overpass,0,4,4,0.0
tokyoxd,Vertigo,0,4,4,0.0
trocka,Inferno,0,1,1,0.0
trocka,Vertigo,0,1,1,0.0
uNiQUE,Dust2,0,1,1,0.0
uNiQUE,Inferno,0,1,1,0.0
umomd,Inferno,0,1,1,0.0
undefined,Ancient,3,3,6,0.5
undefined,Inferno,4,4,8,0.5
undefined,Mirage,0,3,3,0.0
undefined,Nuke,4,8,12,0.3333333333333333
undefined,Overpass,0,2,2,0.0
undefined,Vertigo,4,1,5,0.8
vSlash,Dust2,0,1,1,0.0
vSlash,Inferno,1,0,1,1.0
vSlash,Mirage,0,1,1,0.0
vSlash,Nuke,1,0,1,1.0
vSlash,Vertigo,0,1,1,0.0
vampboiclique,Dust2,0,1,1,0.0
vampboiclique,Inferno,0,1,1,0.0
voLante,Dust2,0,1,1,0.0
voLante,Inferno,0,2,2,0.0
voLante,Mirage,0,2,2,0.0
voLante,Nuke,0,4,4,0.0
voLante,Overpass,1,0,1,1.0
voLante,Vertigo,0,3,3,0.0
wannafly,Ancient,0,1,1,0.0
wannafly,Inferno,1,0,1,1.0
wannafly,Vertigo,1,0,1,1.0
x6tence,Ancient,0,1,1,0.0
x6tence,Dust2,0,1,1,0.0
x6tence,Inferno,0,1,1,0.0
xDDDD,Ancient,0,2,2,0.0
xDDDD,Dust2,2,3,5,0.4
xDDDD,Inferno,1,1,2,0.5
xDDDD,Mirage,0,4,4,0.0
xDDDD,Nuke,1,4,5,0.2
xDDDD,Overpass,1,2,3,0.3333333333333333
xDDDD,Vertigo,1,3,4,0.25
yellow,Ancient,4,2,6,0.6666666666666666
yellow,Dust2,2,5,7,0.2857142857142857
yellow,Inferno,5,4,9,0.5555555555555556
yellow,Mirage,1,0,1,1.0
yellow,Nuke,1,1,2,0.5
yellow,Overpass,0,2,2,0.0
yellow,Vertigo,2,2,4,0.5
yodagus,Ancient,0,3,3,0.0
yodagus,Inferno,0,1,1,0.0
yodagus,Mirage,1,3,4,0.25
yodagus,Overpass,3,0,3,1.0
yodagus,Vertigo,0,1,1,0.0
yologang420,Mirage,0,1,1,0.0
yologang420,Overpass,0,1,1,0.0
yur,Inferno,2,0,2,1.0
yur,Nuke,0,2,2,0.0
yur,Overpass,2,0,2,1.0
yur,Vertigo,1,0,1,1.0
ztrfanclub,Inferno,2,0,2,1.0
ztrfanclub,Mirage,1,0,1,1.0
ztrfanclub,Overpass,1,0,1,1.0
zu krass,Ancient,1,1,2,0.5
zu krass,Inferno,0,1,1,0.0
zu krass,Overpass,1,0,1,1.0
ГћГіr,Nuke,0,1,1,0.0
ГћГіr,Overpass,0,1,1,0.0
